MR	ref
name[Blue Spice], eatType[coffee shop], area[city centre]	Blue Spice is a coffee shop in the city centre.
name[Blue Spice], eatType[coffee shop], area[riverside]	Blue Spice is a coffee shop in the riverside area.
name[Blue Spice], eatType[coffee shop], customer rating[5 out of 5], near[Crowne Plaza Hotel]	Blue Spice is a coffee shop near Crowne Plaza Hotel with a customer rating of 5 out of 5.
name[Blue Spice], eatType[coffee shop], customer rating[average], near[Burger King]	Blue Spice is a coffee shop near Burger King. It has an average customer rating.
name[Blue Spice], eatType[coffee shop], customer rating[average], near[Crowne Plaza Hotel]	Blue Spice is a coffee shop near Crowne Plaza Hotel. It has an average customer rating.
name[Blue Spice], eatType[pub], area[city centre]	Blue Spice is a pub in the city centre.
name[Blue Spice], eatType[pub], area[riverside]	Blue Spice is a pub in the riverside area.
name[Blue Spice], eatType[pub], customer rating[5 out of 5], near[Crowne Plaza Hotel]	Blue Spice is a pub near Crowne Plaza Hotel with a customer rating of 5 out of 5.
name[Blue Spice], eatType[pub], customer rating[average], near[Burger King]	Blue Spice is a pub near Burger King. It has an average customer rating.
name[Blue Spice], eatType[pub], customer rating[average], near[Crowne Plaza Hotel]	Blue Spice is a pub near Crowne Plaza Hotel with an average customer rating.
name[Blue Spice], eatType[pub], food[Chinese], area[city centre], familyFriendly[no], near[Rainbow Vegetarian Café]	Blue Spice is a pub providing Chinese food. It is located in the city centre. It is near Rainbow Vegetarian Café.
name[Blue Spice], eatType[pub], food[Chinese], area[city centre], familyFriendly[yes], near[Rainbow Vegetarian Café]	Blue Spice is a pub that provides Chinese food. It is located in the city centre. It is near Rainbow Vegetarian Café.
name[Blue Spice], eatType[pub], food[Chinese], area[riverside], familyFriendly[no], near[Rainbow Vegetarian Café]	Blue Spice is a pub providing Chinese food. It is located in the riverside. It is near Rainbow Vegetarian Café.
name[Blue Spice], eatType[pub], food[Chinese], area[riverside], familyFriendly[yes], near[Rainbow Vegetarian Café]	Blue Spice is a pub that provides Chinese food. It is located in the riverside. It is near Rainbow Vegetarian Café.
name[Blue Spice], eatType[pub], food[English], area[city centre], familyFriendly[no], near[Rainbow Vegetarian Café]	Located near the Rainbow Vegetarian Café in the city centre, Blue Spice is an English pub that is not family-friendly.
name[Blue Spice], eatType[pub], food[English], area[city centre], familyFriendly[yes], near[Rainbow Vegetarian Café]	Located near the Rainbow Vegetarian Café in the city centre, Blue Spice is a family-friendly pub serving English food.
name[Blue Spice], eatType[pub], food[English], area[riverside], familyFriendly[no], near[Rainbow Vegetarian Café]	Near the Rainbow Vegetarian Café in the riverside area is a pub called Blue Spice. It serves English food and is not family-friendly.
name[Blue Spice], eatType[pub], food[English], area[riverside], familyFriendly[yes], near[Rainbow Vegetarian Café]	Near the Rainbow Vegetarian Café in the riverside area, there is a family friendly English pub called Blue Spice.
name[Blue Spice], eatType[restaurant], food[Chinese], area[city centre], familyFriendly[no], near[Rainbow Vegetarian Café]	Blue Spice is a Chinese restaurant located in the city centre near Rainbow Vegetarian Café. It is not family friendly.
name[Blue Spice], eatType[restaurant], food[Chinese], area[city centre], familyFriendly[yes], near[Rainbow Vegetarian Café]	Blue Spice is a family friendly Chinese restaurant in the city centre near Rainbow Vegetarian Café.
name[Blue Spice], eatType[restaurant], food[Chinese], area[riverside], familyFriendly[no], near[Rainbow Vegetarian Café]	Blue Spice is a restaurant providing Chinese food. It is located in the riverside. It is near Rainbow Vegetarian Café.
name[Blue Spice], eatType[restaurant], food[Chinese], area[riverside], familyFriendly[yes], near[Rainbow Vegetarian Café]	Blue Spice is a family friendly Chinese restaurant in the riverside area near Rainbow Vegetarian Café.
name[Blue Spice], eatType[restaurant], food[English], area[city centre], familyFriendly[no], near[Rainbow Vegetarian Café]	In the city centre, near the Rainbow Vegetarian Café, there is an English restaurant called Blue Spice. It is not family-friendly.
name[Blue Spice], eatType[restaurant], food[English], area[city centre], familyFriendly[yes], near[Rainbow Vegetarian Café]	Located in the city centre near the Rainbow Vegetarian Café, Blue Spice is a family-friendly restaurant serving English food.
name[Blue Spice], eatType[restaurant], food[English], area[riverside], familyFriendly[no], near[Rainbow Vegetarian Café]	Near the Rainbow Vegetarian Café in the riverside area is a restaurant called Blue Spice. It serves English food and is not family-friendly.
name[Blue Spice], eatType[restaurant], food[English], area[riverside], familyFriendly[yes], near[Rainbow Vegetarian Café]	Near the Rainbow Vegetarian Café in the riverside area is a family friendly English restaurant called Blue Spice.
name[Clowns], eatType[coffee shop], customer rating[3 out of 5], near[All Bar One]	Clowns is a coffee shop near All Bar One. It has a customer rating of 3 out of 5.
name[Clowns], eatType[coffee shop], customer rating[5 out of 5], near[Crowne Plaza Hotel]	Clowns is a coffee shop near Crowne Plaza Hotel with a customer rating of 5 out of 5.
name[Clowns], eatType[coffee shop], near[The Sorrento]	Clowns is a coffee shop near The Sorrento.
name[Clowns], eatType[pub], customer rating[3 out of 5], near[All Bar One]	Clowns is a pub near All Bar One with a customer rating of 3 out of 5.
name[Clowns], eatType[pub], customer rating[5 out of 5], near[Crowne Plaza Hotel]	Clowns is a pub near Crowne Plaza Hotel with a customer rating of 5 out of 5.
name[Clowns], eatType[pub], near[The Sorrento]	Clowns is a pub near The Sorrento.
name[Cocum], eatType[coffee shop], customer rating[high], near[Burger King]	Cocum is a highly rated coffee shop near Burger King.
name[Cocum], eatType[coffee shop], customer rating[high], near[Café Sicilia]	Cocum is a coffee shop near Café Sicilia with a high customer rating.
name[Cocum], eatType[coffee shop], customer rating[low], near[Café Sicilia]	Cocum is a coffee shop near Café Sicilia with a low customer rating.
name[Cocum], eatType[coffee shop], customer rating[low], near[Express by Holiday Inn]	Cocum is a coffee shop near Express by Holiday Inn. It has a low customer rating.
name[Cocum], eatType[coffee shop], near[The Rice Boat]	Cocum is a coffee shop near The Rice Boat.
name[Cocum], eatType[coffee shop], near[The Sorrento]	Cocum is a coffee shop near The Sorrento.
name[Cocum], eatType[pub], customer rating[high], near[Burger King]	Cocum is a pub near Burger King with a high customer rating.
name[Cocum], eatType[pub], customer rating[high], near[Café Sicilia]	Cocum is a pub near Café Sicilia with a high customer rating.
name[Cocum], eatType[pub], customer rating[low], near[Café Sicilia]	Cocum is a pub near Café Sicilia with a low customer rating.
name[Cocum], eatType[pub], customer rating[low], near[Express by Holiday Inn]	Cocum is a pub near Express by Holiday Inn with a low customer rating.
name[Cocum], eatType[pub], near[The Rice Boat]	Near The Rice Boat is a pub called Cocum.
name[Cocum], eatType[pub], near[The Sorrento]	Near The Sorrento is a pub called Cocum.
name[Cotto], eatType[coffee shop], near[The Bakers]	Cotto is a coffee shop near The Portland Arms.
name[Cotto], eatType[pub], near[The Bakers]	Cotto is a pub near The Portland Arms.
name[Giraffe], eatType[coffee shop], near[The Bakers]	Giraffe is a coffee shop near The Bakers.
name[Giraffe], eatType[coffee shop], near[The Rice Boat]	Giraffe is a coffee shop near The Rice Boat.
name[Giraffe], eatType[pub], food[English], area[riverside], familyFriendly[yes], near[Rainbow Vegetarian Café]	Giraffe is a family friendly English pub near Rainbow Vegetarian Café in the riverside area.
name[Giraffe], eatType[pub], food[Fast food], area[city centre], familyFriendly[no], near[Rainbow Vegetarian Café]	Giraffe is a fast food pub near Rainbow Vegetarian Café in the city centre. It is not family-friendly.
name[Giraffe], eatType[pub], food[Fast food], area[city centre], familyFriendly[yes], near[Rainbow Vegetarian Café]	Giraffe is a family-friendly fast food pub near Rainbow Vegetarian Café in the city centre.
name[Giraffe], eatType[pub], food[Fast food], area[riverside], familyFriendly[no], near[Rainbow Vegetarian Café]	Giraffe is a fast food pub near Rainbow Vegetarian Café in the riverside area. It is not family-friendly.
name[Giraffe], eatType[pub], food[Fast food], area[riverside], familyFriendly[yes], near[Rainbow Vegetarian Café]	Giraffe is a family friendly fast food pub near Rainbow Vegetarian Café in the riverside area.
name[Giraffe], eatType[pub], food[Fast food], area[riverside], familyFriendly[yes], near[Raja Indian Cuisine]	Giraffe is a family friendly fast food pub near Raja Indian Cuisine in the riverside area.
name[Giraffe], eatType[pub], food[French], area[city centre], familyFriendly[no], near[Raja Indian Cuisine]	Giraffe is a pub serving French food near Raja Indian Cuisine in the city centre. It is not family-friendly.
name[Giraffe], eatType[pub], food[French], area[city centre], familyFriendly[yes], near[Raja Indian Cuisine]	Giraffe is a family-friendly pub serving French food near Raja Indian Cuisine in the city centre.
name[Giraffe], eatType[pub], food[French], area[riverside], familyFriendly[no], near[Raja Indian Cuisine]	Giraffe is a pub providing French food. It is located in riverside near Raja Indian Cuisine.
name[Giraffe], eatType[pub], food[French], area[riverside], familyFriendly[yes], near[Raja Indian Cuisine]	Giraffe is a family friendly pub serving French food in the riverside area near Raja Indian Cuisine.
name[Giraffe], eatType[pub], near[The Bakers]	Giraffe is a pub near The Bakers.
name[Giraffe], eatType[pub], near[The Rice Boat]	Giraffe is a pub near The Rice Boat.
name[Giraffe], eatType[restaurant], food[English], area[riverside], familyFriendly[yes], near[Rainbow Vegetarian Café]	Giraffe is a family friendly English restaurant near Rainbow Vegetarian Café in the riverside area.
name[Giraffe], eatType[restaurant], food[Fast food], area[city centre], familyFriendly[no], near[Rainbow Vegetarian Café]	Giraffe is a fast food restaurant located near Rainbow Vegetarian Café in the city centre. It is not family-friendly.
name[Giraffe], eatType[restaurant], food[Fast food], area[city centre], familyFriendly[yes], near[Rainbow Vegetarian Café]	Giraffe is a family-friendly fast food restaurant near Rainbow Vegetarian Café in the city centre.
name[Giraffe], eatType[restaurant], food[Fast food], area[riverside], familyFriendly[no], near[Rainbow Vegetarian Café]	Giraffe is a fast food restaurant near Rainbow Vegetarian Café in the riverside area. It is not family-friendly.
name[Giraffe], eatType[restaurant], food[Fast food], area[riverside], familyFriendly[yes], near[Rainbow Vegetarian Café]	Giraffe is a family friendly fast food restaurant in the riverside area near Rainbow Vegetarian Café.
name[Giraffe], eatType[restaurant], food[Fast food], area[riverside], familyFriendly[yes], near[Raja Indian Cuisine]	Giraffe is a kid friendly fast food restaurant in the riverside area near Raja Indian Cuisine.
name[Giraffe], eatType[restaurant], food[French], area[city centre], familyFriendly[no], near[Raja Indian Cuisine]	Giraffe is a French restaurant near Raja Indian Cuisine in the city centre. It is not family-friendly.
name[Giraffe], eatType[restaurant], food[French], area[city centre], familyFriendly[yes], near[Raja Indian Cuisine]	Giraffe is a family-friendly French restaurant near Raja Indian Cuisine in the city centre.
name[Giraffe], eatType[restaurant], food[French], area[riverside], familyFriendly[no], near[Raja Indian Cuisine]	Giraffe is a French restaurant near Raja Indian Cuisine in the riverside area. It is not family-friendly.
name[Giraffe], eatType[restaurant], food[French], area[riverside], familyFriendly[yes], near[Raja Indian Cuisine]	Giraffe is a family friendly French restaurant in riverside near Raja Indian Cuisine.
name[Green Man], eatType[coffee shop], customer rating[1 out of 5], near[All Bar One]	Green Man is a coffee shop near All Bar One. It has a customer rating of 1 out of 5.
name[Green Man], eatType[coffee shop], customer rating[3 out of 5], near[All Bar One]	Green Man is a coffee shop near All Bar One. It has a customer rating of 3 out of 5.
name[Green Man], eatType[pub], customer rating[1 out of 5], near[All Bar One]	Green Man is a pub near All Bar One with a customer rating of 1 out of 5.
name[Green Man], eatType[pub], customer rating[3 out of 5], near[All Bar One]	Green Man is a pub near All Bar One with a customer rating of 3 out of 5.
name[Green Man], eatType[pub], food[Italian], area[riverside], familyFriendly[yes], near[Express by Holiday Inn]	Green Man is a family friendly Italian pub in the riverside area near Express by Holiday Inn.
name[Green Man], eatType[pub], food[Italian], area[riverside], familyFriendly[yes], near[Raja Indian Cuisine]	Green Man is a family friendly Italian pub in the riverside area near Raja Indian Cuisine.
name[Green Man], eatType[pub], food[Japanese], area[city centre], familyFriendly[no], near[Express by Holiday Inn]	In the city centre, near the Express by Holiday Inn, is a Japanese pub called Green Man. It is not family-friendly.
name[Green Man], eatType[pub], food[Japanese], area[city centre], familyFriendly[yes], near[Express by Holiday Inn]	Green Man is a family-friendly pub serving Japanese food in the city centre near Express by Holiday Inn.
name[Green Man], eatType[pub], food[Japanese], area[riverside], familyFriendly[no], near[Express by Holiday Inn]	Near the Express by Holiday Inn in the riverside area is a Japanese pub called Green Man. It is not family-friendly.
name[Green Man], eatType[pub], food[Japanese], area[riverside], familyFriendly[yes], near[Express by Holiday Inn]	Green Man is a family friendly Japanese pub in the riverside area near Express by Holiday Inn.
name[Green Man], eatType[restaurant], food[Italian], area[riverside], familyFriendly[yes], near[Express by Holiday Inn]	Green Man is a family friendly Italian restaurant in the riverside area near Express by Holiday Inn.
name[Green Man], eatType[restaurant], food[Italian], area[riverside], familyFriendly[yes], near[Raja Indian Cuisine]	Green Man is a family friendly Italian restaurant in the riverside area near Raja Indian Cuisine.
name[Green Man], eatType[restaurant], food[Japanese], area[city centre], familyFriendly[no], near[Express by Holiday Inn]	Green Man is a Japanese restaurant located in the city centre near Express by Holiday Inn. It is not family-friendly.
name[Green Man], eatType[restaurant], food[Japanese], area[city centre], familyFriendly[yes], near[Express by Holiday Inn]	Green Man is a family-friendly Japanese restaurant in the city centre near Express by Holiday Inn.
name[Green Man], eatType[restaurant], food[Japanese], area[riverside], familyFriendly[no], near[Express by Holiday Inn]	Near Express by Holiday Inn in the riverside area is a Japanese restaurant called Green Man. It is not family-friendly.
name[Green Man], eatType[restaurant], food[Japanese], area[riverside], familyFriendly[yes], near[Express by Holiday Inn]	Green Man is a family friendly Japanese restaurant near Express by Holiday Inn in the riverside area.
name[Loch Fyne], eatType[coffee shop], area[riverside]	Loch Fyne is a riverside coffee shop.
name[Loch Fyne], eatType[pub], area[riverside]	Loch Fyne is a pub in the riverside area.
name[Strada], eatType[coffee shop], area[city centre]	Strada is a coffee shop located in the city centre.
name[Strada], eatType[coffee shop], customer rating[1 out of 5], near[All Bar One]	Strada is a coffee shop near All Bar One with a customer rating of 1 out of 5.
name[Strada], eatType[coffee shop], customer rating[1 out of 5], near[Rainbow Vegetarian Café]	Strada is a coffee shop near Rainbow Vegetarian Café with a customer rating of 1 out of 5.
name[Strada], eatType[coffee shop], customer rating[low], near[Express by Holiday Inn]	Strada is a low rated coffee shop near Express by Holiday Inn.
name[Strada], eatType[pub], area[city centre]	Strada is a pub located in the city centre.
name[Strada], eatType[pub], customer rating[1 out of 5], near[All Bar One]	Strada is a pub near All Bar One with a customer rating of 1 out of 5.
name[Strada], eatType[pub], customer rating[1 out of 5], near[Rainbow Vegetarian Café]	Strada is a pub near Rainbow Vegetarian Café with a customer rating of 1 out of 5.
name[Strada], eatType[pub], customer rating[low], near[Express by Holiday Inn]	Strada is a pub near Express by Holiday Inn with a low customer rating.
name[The Cricketers], eatType[coffee shop], customer rating[1 out of 5], familyFriendly[yes], near[Avalon]	The Cricketers is a kid friendly coffee shop near Avalon with a customer rating of 1 out of 5.
name[The Cricketers], eatType[coffee shop], customer rating[3 out of 5], familyFriendly[yes], near[Avalon]	The Cricketers is a kid friendly coffee shop near Avalon with a customer rating of 3 out of 5.
name[The Cricketers], eatType[coffee shop], customer rating[3 out of 5], familyFriendly[yes], near[Crowne Plaza Hotel]	The Cricketers is a children friendly coffee shop near Crowne Plaza Hotel with a customer rating of 3 out of 5.
name[The Cricketers], eatType[coffee shop], customer rating[5 out of 5], familyFriendly[no], near[Crowne Plaza Hotel]	The Cricketers is a highly rated coffee shop near Crowne Plaza Hotel. It is not family-friendly.
name[The Cricketers], eatType[coffee shop], customer rating[5 out of 5], familyFriendly[yes], near[Crowne Plaza Hotel]	The Cricketers is a family friendly coffee shop near Crowne Plaza Hotel with a customer rating of 5 out of 5.
name[The Cricketers], eatType[coffee shop], customer rating[average], familyFriendly[no], near[Café Sicilia]	The Cricketers is a non-family-friendly coffee shop near Café Sicilia with an average customer rating.
name[The Cricketers], eatType[coffee shop], customer rating[average], familyFriendly[no], near[Crowne Plaza Hotel]	The Cricketers is a non family-friendly coffee shop near Crowne Plaza Hotel with an average customer rating.
name[The Cricketers], eatType[coffee shop], customer rating[average], familyFriendly[yes], near[Café Sicilia]	The Cricketers is a family friendly coffee shop near Café Sicilia with an average customer rating.
name[The Cricketers], eatType[coffee shop], customer rating[high], familyFriendly[yes], near[Café Sicilia]	The Cricketers is a children friendly coffee shop near Café Sicilia with a high customer rating.
name[The Cricketers], eatType[coffee shop], customer rating[high], familyFriendly[yes], near[Express by Holiday Inn]	The Cricketers is a children friendly coffee shop near Express by Holiday Inn with a high customer rating.
name[The Cricketers], eatType[coffee shop], customer rating[low], familyFriendly[no], near[Express by Holiday Inn]	The Cricketers is a coffee shop near Express by Holiday Inn. It is not family-friendly and has a low customer rating.
name[The Cricketers], eatType[coffee shop], customer rating[low], familyFriendly[no], near[Ranch]	The Cricketers is a coffee shop near Ranch. It is not family-friendly and has a low customer rating.
name[The Cricketers], eatType[coffee shop], customer rating[low], familyFriendly[yes], near[Ranch]	The Cricketers is a family friendly coffee shop near Ranch with a low customer rating.
name[The Cricketers], eatType[restaurant], customer rating[1 out of 5], familyFriendly[yes], near[Avalon]	The Cricketers is a kid friendly restaurant near Avalon with a customer rating of 1 out of 5.
name[The Cricketers], eatType[restaurant], customer rating[3 out of 5], familyFriendly[yes], near[Avalon]	The Cricketers is a kids friendly restaurant near Avalon with a customer rating of 3 out of 5.
name[The Cricketers], eatType[restaurant], customer rating[3 out of 5], familyFriendly[yes], near[Crowne Plaza Hotel]	The Cricketers is a kids friendly restaurant near Crowne Plaza Hotel with a customer rating of 3 out of 5.
name[The Cricketers], eatType[restaurant], customer rating[5 out of 5], familyFriendly[no], near[Crowne Plaza Hotel]	The Cricketers is a restaurant near the Crowne Plaza Hotel. It has a customer rating of 5 out of 5 and is not family-friendly.
name[The Cricketers], eatType[restaurant], customer rating[5 out of 5], familyFriendly[yes], near[Crowne Plaza Hotel]	The Cricketers is a family friendly restaurant near the Crowne Plaza Hotel with a customer rating of 5 out of 5.
name[The Cricketers], eatType[restaurant], customer rating[average], familyFriendly[no], near[Café Sicilia]	The Cricketers is a restaurant near Café Sicilia. It has an average customer rating and is not family-friendly.
name[The Cricketers], eatType[restaurant], customer rating[average], familyFriendly[no], near[Crowne Plaza Hotel]	The Cricketers is a restaurant near the Crowne Plaza Hotel. It has an average customer rating and is not family-friendly.
name[The Cricketers], eatType[restaurant], customer rating[average], familyFriendly[yes], near[Café Sicilia]	The Cricketers is a family friendly restaurant near Café Sicilia with an average customer rating.
name[The Cricketers], eatType[restaurant], customer rating[high], familyFriendly[yes], near[Café Sicilia]	The Cricketers is a children friendly restaurant near Café Sicilia with a high customer rating.
name[The Cricketers], eatType[restaurant], customer rating[high], familyFriendly[yes], near[Express by Holiday Inn]	The Cricketers is a children friendly restaurant near Express by Holiday Inn with a high customer rating.
name[The Cricketers], eatType[restaurant], customer rating[low], familyFriendly[no], near[Express by Holiday Inn]	The Cricketers is a restaurant near Express by Holiday Inn. It is not family-friendly and has a low customer rating.
name[The Cricketers], eatType[restaurant], customer rating[low], familyFriendly[no], near[Ranch]	The Cricketers is a restaurant near Ranch. It is not family-friendly and has a low customer rating.
name[The Cricketers], eatType[restaurant], customer rating[low], familyFriendly[yes], near[Ranch]	The Cricketers is a family friendly restaurant near Ranch with a low customer rating.
name[The Cricketers], eatType[restaurant], food[Chinese], priceRange[£20-25], customer rating[high], area[city centre], familyFriendly[no], near[All Bar One]	The Cricketers is a restaurant providing Chinese food in the £20-25 price range. It is located in the city centre. It is near All Bar One. Its customer rating is high.
name[The Cricketers], eatType[restaurant], food[Chinese], priceRange[£20-25], customer rating[high], area[city centre], familyFriendly[yes], near[All Bar One]	The Cricketers is a restaurant providing Chinese food in the £20-25 price range. It is located in the city centre. It is near All Bar One. Its customer rating is high.
name[The Cricketers], eatType[restaurant], food[Chinese], priceRange[£20-25], customer rating[high], area[riverside], familyFriendly[no], near[All Bar One]	The Cricketers is a restaurant providing Chinese food in the £20-25 price range. It is located in the riverside. It is near All Bar One. Its customer rating is high.
name[The Cricketers], eatType[restaurant], food[Chinese], priceRange[£20-25], customer rating[high], area[riverside], familyFriendly[yes], near[All Bar One]	The Cricketers is a restaurant providing Chinese food in the £20-25 price range. It is located in the riverside. It is near All Bar One. Its customer rating is high.
name[The Cricketers], eatType[restaurant], food[Chinese], priceRange[cheap], customer rating[5 out of 5], area[city centre], familyFriendly[no], near[All Bar One]	The Cricketers is a restaurant providing Chinese food in the cheap price range. It is located in the city centre. It is near All Bar One. Its customer rating is 5 out of 5.
name[The Cricketers], eatType[restaurant], food[Chinese], priceRange[cheap], customer rating[5 out of 5], area[city centre], familyFriendly[yes], near[All Bar One]	The Cricketers is a restaurant providing Chinese food in the cheap price range. It is located in the city centre. It is near All Bar One. Its customer rating is 5 out of 5.
name[The Cricketers], eatType[restaurant], food[Chinese], priceRange[cheap], customer rating[5 out of 5], area[riverside], familyFriendly[no], near[All Bar One]	The Cricketers is a restaurant providing Chinese food in the cheap price range. It is located in the riverside. It is near All Bar One. Its customer rating is 5 out of 5.
name[The Cricketers], eatType[restaurant], food[Chinese], priceRange[cheap], customer rating[5 out of 5], area[riverside], familyFriendly[yes], near[All Bar One]	The Cricketers is a restaurant providing Chinese food in the cheap price range. It is located in the riverside. It is near All Bar One. Its customer rating is 5 out of 5.
name[The Cricketers], eatType[restaurant], food[Chinese], priceRange[cheap], customer rating[average], area[city centre], familyFriendly[no], near[All Bar One]	The Cricketers is a restaurant providing Chinese food in the cheap price range. It is located in the city centre. It is near All Bar One. Its customer rating is average.
name[The Cricketers], eatType[restaurant], food[Chinese], priceRange[cheap], customer rating[average], area[city centre], familyFriendly[yes], near[All Bar One]	The Cricketers is a restaurant providing Chinese food in the cheap price range. It is located in the city centre. It is near All Bar One. Its customer rating is average.
name[The Cricketers], eatType[restaurant], food[Chinese], priceRange[cheap], customer rating[average], area[riverside], familyFriendly[no], near[All Bar One]	The Cricketers is a restaurant providing Chinese food in the cheap price range. It is located in the riverside. It is near All Bar One. Its customer rating is average.
name[The Cricketers], eatType[restaurant], food[Chinese], priceRange[cheap], customer rating[average], area[riverside], familyFriendly[yes], near[All Bar One]	The Cricketers is a Chinese restaurant with a cheap price range. It has an average customer rating and is family friendly. It is located in the riverside area near All Bar One.
name[The Cricketers], eatType[restaurant], food[Chinese], priceRange[high], customer rating[1 out of 5], area[city centre], familyFriendly[no], near[All Bar One]	The Cricketers is a restaurant providing Chinese food in the high price range. It is located in the city centre. It is near All Bar One. Its customer rating is 1 out of 5.
name[The Cricketers], eatType[restaurant], food[Chinese], priceRange[high], customer rating[1 out of 5], area[city centre], familyFriendly[yes], near[All Bar One]	The Cricketers is a restaurant providing Chinese food in the high price range. It is located in the city centre. It is near All Bar One. Its customer rating is 1 out of 5.
name[The Cricketers], eatType[restaurant], food[Chinese], priceRange[high], customer rating[1 out of 5], area[riverside], familyFriendly[no], near[All Bar One]	The Cricketers is a restaurant providing Chinese food in the high price range. It is located in the riverside. It is near All Bar One. Its customer rating is 1 out of 5.
name[The Cricketers], eatType[restaurant], food[Chinese], priceRange[high], customer rating[1 out of 5], area[riverside], familyFriendly[yes], near[All Bar One]	The Cricketers is a restaurant providing Chinese food in the high price range. It is located in the riverside. It is near All Bar One. Its customer rating is 1 out of 5.
name[The Cricketers], eatType[restaurant], food[Chinese], priceRange[high], customer rating[average], area[city centre], familyFriendly[no], near[All Bar One]	The Cricketers is a restaurant providing Chinese food in the high price range. It is located in the city centre. It is near All Bar One. Its customer rating is average.
name[The Cricketers], eatType[restaurant], food[Chinese], priceRange[high], customer rating[average], area[city centre], familyFriendly[yes], near[All Bar One]	The Cricketers is a restaurant providing Chinese food in the high price range. It is located in the city centre. It is near All Bar One. Its customer rating is average.
name[The Cricketers], eatType[restaurant], food[Chinese], priceRange[high], customer rating[average], area[riverside], familyFriendly[no], near[All Bar One]	The Cricketers is a restaurant providing Chinese food in the high price range. It is located in the riverside. It is near All Bar One. Its customer rating is average.
name[The Cricketers], eatType[restaurant], food[Chinese], priceRange[high], customer rating[average], area[riverside], familyFriendly[yes], near[All Bar One]	The Cricketers is a restaurant providing Chinese food in the high price range. It is located in the riverside. It is near All Bar One. Its customer rating is average.
name[The Cricketers], eatType[restaurant], food[Chinese], priceRange[less than £20], customer rating[low], area[city centre], familyFriendly[no], near[All Bar One]	The Cricketers is a restaurant providing Chinese food in the less than £20 price range. It is located in the city centre. It is near All Bar One. Its customer rating is low.
name[The Cricketers], eatType[restaurant], food[Chinese], priceRange[less than £20], customer rating[low], area[city centre], familyFriendly[yes], near[All Bar One]	The Cricketers is a family friendly Chinese restaurant in the city centre near All Bar One with a low customer rating and a price range of less than £20.
name[The Cricketers], eatType[restaurant], food[Chinese], priceRange[less than £20], customer rating[low], area[riverside], familyFriendly[no], near[All Bar One]	The Cricketers is a restaurant providing Chinese food in the less than £20 price range. It is located in the riverside. It is near All Bar One. Its customer rating is low.
name[The Cricketers], eatType[restaurant], food[Chinese], priceRange[less than £20], customer rating[low], area[riverside], familyFriendly[yes], near[All Bar One]	The Cricketers is a family friendly Chinese restaurant with a price range of less than £20. It has a low customer rating and is located in the riverside area near All Bar One.
name[The Cricketers], eatType[restaurant], food[Chinese], priceRange[moderate], customer rating[1 out of 5], area[city centre], familyFriendly[no], near[All Bar One]	The Cricketers is a restaurant providing Chinese food in the moderate price range. It is located in the city centre. It is near All Bar One. Its customer rating is 1 out of 5.
name[The Cricketers], eatType[restaurant], food[Chinese], priceRange[moderate], customer rating[1 out of 5], area[city centre], familyFriendly[yes], near[All Bar One]	The Cricketers is a restaurant providing Chinese food in the moderate price range. It is located in the city centre. It is near All Bar One. Its customer rating is 1 out of 5.
name[The Cricketers], eatType[restaurant], food[Chinese], priceRange[moderate], customer rating[1 out of 5], area[riverside], familyFriendly[no], near[All Bar One]	The Cricketers is a restaurant providing Chinese food in the moderate price range. It is located in the riverside. It is near All Bar One. Its customer rating is 1 out of 5.
name[The Cricketers], eatType[restaurant], food[Chinese], priceRange[moderate], customer rating[1 out of 5], area[riverside], familyFriendly[yes], near[All Bar One]	The Cricketers is a restaurant providing Chinese food in the moderate price range. It is located in the riverside. It is near All Bar One. Its customer rating is 1 out of 5.
name[The Cricketers], eatType[restaurant], food[Chinese], priceRange[moderate], customer rating[3 out of 5], area[city centre], familyFriendly[no], near[All Bar One]	The Cricketers is a restaurant providing Chinese food in the moderate price range. It is located in the city centre. It is near All Bar One. Its customer rating is 3 out of 5.
name[The Cricketers], eatType[restaurant], food[Chinese], priceRange[moderate], customer rating[3 out of 5], area[city centre], familyFriendly[yes], near[All Bar One]	The Cricketers is a restaurant providing Chinese food in the moderate price range. It is located in the city centre. It is near All Bar One. Its customer rating is 3 out of 5.
name[The Cricketers], eatType[restaurant], food[Chinese], priceRange[moderate], customer rating[3 out of 5], area[riverside], familyFriendly[no], near[All Bar One]	The Cricketers is a restaurant providing Chinese food in the moderate price range. It is located in the riverside. It is near All Bar One. Its customer rating is 3 out of 5.
name[The Cricketers], eatType[restaurant], food[Chinese], priceRange[moderate], customer rating[3 out of 5], area[riverside], familyFriendly[yes], near[All Bar One]	The Cricketers is a restaurant providing Chinese food in the moderate price range. It is located in the riverside. It is near All Bar One. Its customer rating is 3 out of 5.
name[The Cricketers], eatType[restaurant], food[Chinese], priceRange[more than £30], customer rating[high], area[city centre], familyFriendly[no], near[All Bar One]	The Cricketers is a restaurant providing Chinese food in the more than £30 price range. It is located in the city centre. It is near All Bar One. Its customer rating is high.
name[The Cricketers], eatType[restaurant], food[Chinese], priceRange[more than £30], customer rating[high], area[city centre], familyFriendly[yes], near[All Bar One]	The Cricketers is a restaurant providing Chinese food in the more than £30 price range. It is located in the city centre. It is near All Bar One. Its customer rating is high.
name[The Cricketers], eatType[restaurant], food[Chinese], priceRange[more than £30], customer rating[high], area[riverside], familyFriendly[no], near[All Bar One]	The Cricketers is a restaurant providing Chinese food in the more than £30 price range. It is located in the riverside. It is near All Bar One. Its customer rating is high.
name[The Cricketers], eatType[restaurant], food[Chinese], priceRange[more than £30], customer rating[high], area[riverside], familyFriendly[yes], near[All Bar One]	The Cricketers is a restaurant providing Chinese food in the more than £30 price range. It is located in the riverside. It is near All Bar One. Its customer rating is high.
name[The Cricketers], eatType[restaurant], food[English], priceRange[£20-25], customer rating[high], area[city centre], familyFriendly[no], near[All Bar One]	The Cricketers is a restaurant providing English food in the £20-25 price range. It is located in the city centre. It is near All Bar One. Its customer rating is high.
name[The Cricketers], eatType[restaurant], food[English], priceRange[£20-25], customer rating[high], area[city centre], familyFriendly[yes], near[All Bar One]	The Cricketers is a restaurant providing English food in the £20-25 price range. It is located in the city centre. It is near All Bar One. Its customer rating is high.
name[The Cricketers], eatType[restaurant], food[English], priceRange[£20-25], customer rating[high], area[riverside], familyFriendly[no], near[All Bar One]	The Cricketers is a restaurant providing English food in the £20-25 price range. It is located in the riverside. It is near All Bar One. Its customer rating is high.
name[The Cricketers], eatType[restaurant], food[English], priceRange[£20-25], customer rating[high], area[riverside], familyFriendly[yes], near[All Bar One]	The Cricketers is a restaurant providing English food in the £20-25 price range. It is located in the riverside. It is near All Bar One. Its customer rating is high.
name[The Cricketers], eatType[restaurant], food[English], priceRange[cheap], customer rating[5 out of 5], area[city centre], familyFriendly[no], near[Café Rouge]	The Cricketers is a restaurant providing English food in the cheap price range. It is located in the city centre. It is near Café Rouge. Its customer rating is 5 out of 5.
name[The Cricketers], eatType[restaurant], food[English], priceRange[cheap], customer rating[5 out of 5], area[city centre], familyFriendly[yes], near[Café Rouge]	The Cricketers is a restaurant providing English food in the cheap price range. It is located in the city centre. It is near Café Rouge. Its customer rating is 5 out of 5.
name[The Cricketers], eatType[restaurant], food[English], priceRange[cheap], customer rating[5 out of 5], area[riverside], familyFriendly[no], near[Café Rouge]	The Cricketers is a restaurant providing English food in the cheap price range. It is located in the riverside. It is near Café Rouge. Its customer rating is 5 out of 5.
name[The Cricketers], eatType[restaurant], food[English], priceRange[cheap], customer rating[5 out of 5], area[riverside], familyFriendly[yes], near[Café Rouge]	The Cricketers is a family friendly restaurant located near Café Rouge.
name[The Cricketers], eatType[restaurant], food[English], priceRange[cheap], customer rating[average], area[city centre], familyFriendly[no], near[Café Rouge]	The Cricketers is a restaurant providing English food in the cheap price range. It is located in the city centre. It is near Café Rouge. Its customer rating is average.
name[The Cricketers], eatType[restaurant], food[English], priceRange[cheap], customer rating[average], area[city centre], familyFriendly[yes], near[Café Rouge]	The Cricketers is a restaurant providing English food in the cheap price range. It is located in the city centre. It is near Café Rouge. Its customer rating is average.
name[The Cricketers], eatType[restaurant], food[English], priceRange[cheap], customer rating[average], area[riverside], familyFriendly[no], near[Café Rouge]	The Cricketers is a restaurant providing English food in the cheap price range. It is located in the riverside. It is near Café Rouge. Its customer rating is average.
name[The Cricketers], eatType[restaurant], food[English], priceRange[cheap], customer rating[average], area[riverside], familyFriendly[yes], near[Café Rouge]	The Cricketers is a cheap, family-friendly restaurant located near Café Rouge.
name[The Cricketers], eatType[restaurant], food[English], priceRange[high], customer rating[1 out of 5], area[city centre], familyFriendly[no], near[Café Rouge]	The Cricketers is a restaurant providing English food in the high price range. It is located in the city centre. It is near Café Rouge. Its customer rating is 1 out of 5.
name[The Cricketers], eatType[restaurant], food[English], priceRange[high], customer rating[1 out of 5], area[city centre], familyFriendly[yes], near[Café Rouge]	The Cricketers is a restaurant providing English food in the high price range. It is located in the city centre. It is near Café Rouge. Its customer rating is 1 out of 5.
name[The Cricketers], eatType[restaurant], food[English], priceRange[high], customer rating[1 out of 5], area[riverside], familyFriendly[no], near[Café Rouge]	The Cricketers is a restaurant providing English food in the high price range. It is located in the riverside. It is near Café Rouge. Its customer rating is 1 out of 5.
name[The Cricketers], eatType[restaurant], food[English], priceRange[high], customer rating[1 out of 5], area[riverside], familyFriendly[yes], near[Café Rouge]	The Cricketers is a family friendly restaurant located near Café Rouge.
name[The Cricketers], eatType[restaurant], food[English], priceRange[high], customer rating[average], area[city centre], familyFriendly[no], near[Café Rouge]	The Cricketers is a high priced English restaurant near Café Rouge in the city centre. It has an average customer rating and is not child friendly.
name[The Cricketers], eatType[restaurant], food[English], priceRange[high], customer rating[average], area[city centre], familyFriendly[yes], near[Café Rouge]	The Cricketers is a children friendly English restaurant with a high price range and an average customer rating. It is located in the city centre near Café Rouge.
name[The Cricketers], eatType[restaurant], food[English], priceRange[high], customer rating[average], area[riverside], familyFriendly[no], near[Café Rouge]	The Cricketers is a high priced English restaurant in the riverside area near Café Rouge. It has an average customer rating and is not children friendly.
name[The Mill], eatType[pub], food[English], priceRange[high], area[riverside], familyFriendly[yes], near[Raja Indian Cuisine]	The Mill is a children friendly English pub in the riverside area near Raja Indian Cuisine with a high price range.
name[The Mill], eatType[pub], food[English], priceRange[less than £20], area[city centre], familyFriendly[no], near[Raja Indian Cuisine]	The Mill is a pub providing English food in the less than £20 price range. It is located in the city centre. It is near Raja Indian Cuisine.
name[The Mill], eatType[pub], food[English], priceRange[less than £20], area[city centre], familyFriendly[yes], near[Raja Indian Cuisine]	The Mill is a family-friendly pub that serves English food for less than £20. It is located in the city centre near Raja Indian Cuisine.
name[The Mill], eatType[pub], food[English], priceRange[less than £20], area[riverside], familyFriendly[no], near[Raja Indian Cuisine]	The Mill is a low-priced pub located near Raja Indian Cuisine.
name[The Mill], eatType[pub], food[English], priceRange[less than £20], area[riverside], familyFriendly[yes], near[Raja Indian Cuisine]	The Mill is a family friendly pub that serves English food for less than £20. It is located in the riverside area near Raja Indian Cuisine.
name[The Mill], eatType[pub], food[English], priceRange[moderate], area[city centre], familyFriendly[no], near[Raja Indian Cuisine]	The Mill is a moderately priced English pub near Raja Indian Cuisine in the city centre. It is not kid friendly.
name[The Mill], eatType[pub], food[English], priceRange[moderate], area[city centre], familyFriendly[yes], near[Raja Indian Cuisine]	The Mill is a moderately priced, kid friendly pub serving English food in the city centre near Raja Indian Cuisine.
name[The Mill], eatType[pub], food[English], priceRange[moderate], area[riverside], familyFriendly[no], near[Raja Indian Cuisine]	The Mill is a moderately priced English pub in riverside near Raja Indian Cuisine. It is not kid friendly.
name[The Mill], eatType[pub], food[English], priceRange[moderate], area[riverside], familyFriendly[yes], near[Raja Indian Cuisine]	The Mill is a moderately priced, kid friendly pub serving English food in the riverside area near Raja Indian Cuisine.
name[The Mill], eatType[pub], food[English], priceRange[more than £30], area[riverside], familyFriendly[yes], near[Raja Indian Cuisine]	The Mill is a children friendly English pub in riverside near Raja Indian Cuisine with a price range of more than £30.
name[The Mill], eatType[pub], food[Fast food], priceRange[£20-25], area[riverside], familyFriendly[yes], near[Raja Indian Cuisine]	The Mill is a kid friendly fast food pub in the riverside area near Raja Indian Cuisine with a price range of £20-25.
name[The Mill], eatType[pub], food[Fast food], priceRange[£20-25], customer rating[high], area[city centre], familyFriendly[no], near[Café Rouge]	The Mill is a fast food pub located in the city centre near Café Rouge. It has a high customer rating and a price range of £20-25. It is not kids friendly.
name[The Mill], eatType[pub], food[Fast food], priceRange[£20-25], customer rating[high], area[city centre], familyFriendly[yes], near[Café Rouge]	The Mill is a kid-friendly fast food pub in the city centre near Café Rouge. It has a high customer rating and a price range of £20-25.
name[The Mill], eatType[pub], food[Fast food], priceRange[£20-25], customer rating[high], area[riverside], familyFriendly[no], near[Café Rouge]	The Mill is a fast food pub near Café Rouge in the riverside area. It has a high customer rating and a price range of £20-25. It is not kid friendly.
name[The Mill], eatType[pub], food[Fast food], priceRange[£20-25], customer rating[high], area[riverside], familyFriendly[yes], near[Café Rouge]	The Mill is a kid friendly fast food pub in the riverside area near Café Rouge. It has a high customer rating and a price range of £20-25.
name[The Mill], eatType[pub], food[Fast food], priceRange[£20-25], customer rating[high], area[riverside], familyFriendly[yes], near[Café Sicilia]	The Mill is a kid friendly fast food pub in the riverside area near Café Sicilia with a high customer rating and a price range of £20-25.
name[The Mill], eatType[pub], food[Fast food], priceRange[cheap], area[riverside], familyFriendly[yes], near[Raja Indian Cuisine]	The Mill is a cheap, family friendly, fast food pub in the riverside area near Raja Indian Cuisine.
name[The Mill], eatType[pub], food[Fast food], priceRange[cheap], customer rating[5 out of 5], area[city centre], familyFriendly[no], near[Café Sicilia]	The Mill is a cheap fast food pub in the city centre near Café Sicilia. It has a customer rating of 5 out of 5 and is not family-friendly.
name[The Mill], eatType[pub], food[Fast food], priceRange[cheap], customer rating[5 out of 5], area[city centre], familyFriendly[yes], near[Café Sicilia]	The Mill is a cheap, family-friendly, fast food pub in the city centre near Café Sicilia with a customer rating of 5 out of 5.
name[The Mill], eatType[pub], food[Fast food], priceRange[cheap], customer rating[5 out of 5], area[riverside], familyFriendly[no], near[Café Sicilia]	The Mill is a cheap fast food pub in the riverside area near Café Sicilia. It has a customer rating of 5 out of 5 and is not family-friendly.
name[The Mill], eatType[pub], food[Fast food], priceRange[cheap], customer rating[5 out of 5], area[riverside], familyFriendly[yes], near[Café Sicilia]	The Mill is a cheap, family friendly, fast food pub near Café Sicilia in the riverside area with a customer rating of 5 out of 5.
name[The Mill], eatType[pub], food[Fast food], priceRange[cheap], customer rating[average], area[city centre], familyFriendly[no], near[Café Sicilia]	The Mill is a cheap fast food pub near Café Sicilia in the city centre. It has an average customer rating and is not family-friendly.
name[The Mill], eatType[pub], food[Fast food], priceRange[cheap], customer rating[average], area[city centre], familyFriendly[yes], near[Café Sicilia]	The Mill is a cheap, family-friendly, fast food pub in the city centre near Café Sicilia with an average customer rating.
name[The Mill], eatType[pub], food[Fast food], priceRange[cheap], customer rating[average], area[riverside], familyFriendly[no], near[Café Sicilia]	The Mill is a cheap fast food pub in the riverside area near Café Sicilia. It has an average customer rating and is not family-friendly.
name[The Mill], eatType[pub], food[Fast food], priceRange[cheap], customer rating[average], area[riverside], familyFriendly[yes], near[Café Sicilia]	The Mill is a cheap, family friendly, fast food pub near Café Sicilia in the riverside area with an average customer rating.
name[The Mill], eatType[pub], food[Fast food], priceRange[high], customer rating[1 out of 5], area[city centre], familyFriendly[no], near[Café Sicilia]	The Mill is a fast food pub located in the city centre near Café Sicilia. It has a high price range and a customer rating of 1 out of 5. It is not children friendly.
name[The Mill], eatType[pub], food[Fast food], priceRange[high], customer rating[1 out of 5], area[city centre], familyFriendly[yes], near[Café Sicilia]	The Mill is a children friendly fast food pub in the city centre near Café Sicilia with a high price range and a customer rating of 1 out of 5.
name[The Mill], eatType[pub], food[Fast food], priceRange[high], customer rating[1 out of 5], area[riverside], familyFriendly[no], near[Café Sicilia]	The Mill is a fast food pub in the riverside area near Café Sicilia. It has a high price range and a customer rating of 1 out of 5. It is not children friendly.
name[The Mill], eatType[pub], food[Fast food], priceRange[high], customer rating[1 out of 5], area[riverside], familyFriendly[yes], near[Café Sicilia]	The Mill is a high priced, child friendly, fast food pub near Café Sicilia in the riverside area with a customer rating of 1 out of 5.
name[The Mill], eatType[pub], food[Fast food], priceRange[high], customer rating[average], area[city centre], familyFriendly[no], near[Café Sicilia]	The Mill is a fast food pub located in the city centre near Café Sicilia. It has a high price range and an average customer rating. It is not children friendly.
name[The Mill], eatType[pub], food[Fast food], priceRange[high], customer rating[average], area[city centre], familyFriendly[yes], near[Café Sicilia]	The Mill is a children friendly fast food pub in the city centre near Café Sicilia. It has a high price range and an average customer rating.
name[The Mill], eatType[pub], food[Fast food], priceRange[high], customer rating[average], area[riverside], familyFriendly[no], near[Café Sicilia]	The Mill is a fast food pub in the riverside area near Café Sicilia. It has a high price range and an average customer rating. It is not children friendly.
name[The Mill], eatType[pub], food[Fast food], priceRange[high], customer rating[average], area[riverside], familyFriendly[yes], near[Café Sicilia]	The Mill is a high priced, average rated, child friendly, fast food pub near Café Sicilia in the riverside area.
name[The Mill], eatType[pub], food[Fast food], priceRange[less than £20], customer rating[low], area[city centre], familyFriendly[no], near[Café Sicilia]	The Mill is a fast food pub located in the city centre near Café Sicilia. It is not family-friendly, has a low customer rating and a price range of less than £20.
name[The Mill], eatType[pub], food[Fast food], priceRange[less than £20], customer rating[low], area[city centre], familyFriendly[yes], near[Café Sicilia]	The Mill is a family-friendly fast food pub in the city centre near Café Sicilia with a low customer rating and a price range of less than £20.
name[The Mill], eatType[pub], food[Fast food], priceRange[less than £20], customer rating[low], area[riverside], familyFriendly[no], near[Café Sicilia]	The Mill is a fast food pub near Café Sicilia in the riverside area. It is not family-friendly and has a low customer rating. The price range is less than £20.
name[The Mill], eatType[pub], food[Fast food], priceRange[less than £20], customer rating[low], area[riverside], familyFriendly[yes], near[Café Sicilia]	The Mill is a cheap, family friendly pub located near Café Sicilia.
name[The Mill], eatType[pub], food[Fast food], priceRange[moderate], customer rating[1 out of 5], area[city centre], familyFriendly[no], near[Café Sicilia]	The Mill is a moderately priced fast food pub near Café Sicilia in the city centre. It is not kid friendly and has a customer rating of 1 out of 5.
name[The Mill], eatType[pub], food[Fast food], priceRange[moderate], customer rating[1 out of 5], area[city centre], familyFriendly[yes], near[Café Sicilia]	The Mill is a kid friendly fast food pub in the city centre near Café Sicilia with a moderate price range and a customer rating of 1 out of 5.
name[The Mill], eatType[pub], food[Fast food], priceRange[moderate], customer rating[1 out of 5], area[riverside], familyFriendly[no], near[Café Sicilia]	The Mill is a moderately priced fast food pub near Café Sicilia in the riverside area. It is not kid friendly and has a customer rating of 1 out of 5.
name[The Mill], eatType[pub], food[Fast food], priceRange[moderate], customer rating[1 out of 5], area[riverside], familyFriendly[yes], near[Café Sicilia]	The Mill is a moderately priced, kid friendly, fast food pub near Café Sicilia in the riverside area with a customer rating of 1 out of 5.
name[The Mill], eatType[pub], food[Fast food], priceRange[moderate], customer rating[3 out of 5], area[city centre], familyFriendly[no], near[Café Sicilia]	The Mill is a fast food pub located in the city centre near Café Sicilia. It has a customer rating of 3 out of 5 and is not kid friendly.
name[The Mill], eatType[pub], food[Fast food], priceRange[moderate], customer rating[3 out of 5], area[city centre], familyFriendly[yes], near[Café Sicilia]	The Mill is a moderately priced, kid friendly, fast food pub near Café Sicilia in the city centre with a customer rating of 3 out of 5.
name[The Mill], eatType[pub], food[Fast food], priceRange[moderate], customer rating[3 out of 5], area[riverside], familyFriendly[no], near[Café Sicilia]	The Mill is a fast food pub near Café Sicilia in the riverside area. It is not kid friendly and has a customer rating of 3 out of 5.
name[The Mill], eatType[pub], food[Fast food], priceRange[moderate], customer rating[3 out of 5], area[riverside], familyFriendly[yes], near[Café Sicilia]	The Mill is a moderately priced, kid friendly, fast food pub near Café Sicilia in the riverside area with a customer rating of 3 out of 5.
name[The Mill], eatType[restaurant], food[English], priceRange[high], area[riverside], familyFriendly[yes], near[Raja Indian Cuisine]	The Mill is a restaurant providing English food in the high price range. It is located in the riverside. It is near Raja Indian Cuisine.
name[The Mill], eatType[restaurant], food[English], priceRange[high], customer rating[average], area[riverside], familyFriendly[yes], near[Café Rouge]	The Mill is a family friendly restaurant located near Café Rouge.
name[The Mill], eatType[restaurant], food[English], priceRange[less than £20], area[city centre], familyFriendly[no], near[Raja Indian Cuisine]	The Mill is a restaurant providing English food in the less than £20 price range. It is located in the city centre. It is near Raja Indian Cuisine.
name[The Mill], eatType[restaurant], food[English], priceRange[less than £20], area[city centre], familyFriendly[yes], near[Raja Indian Cuisine]	The Mill is a family-friendly restaurant that serves English food for less than £20. It is located in the city centre near Raja Indian Cuisine.
name[The Mill], eatType[restaurant], food[English], priceRange[less than £20], area[riverside], familyFriendly[no], near[Raja Indian Cuisine]	The Mill is a restaurant providing English food in the less than £20 price range. It is located in the riverside. It is near Raja Indian Cuisine.
name[The Mill], eatType[restaurant], food[English], priceRange[less than £20], area[riverside], familyFriendly[yes], near[Raja Indian Cuisine]	The Mill is a family friendly restaurant located near Raja Indian Cuisine.
name[The Mill], eatType[restaurant], food[English], priceRange[less than £20], customer rating[low], area[city centre], familyFriendly[no], near[Café Rouge]	The Mill is a restaurant providing English food in the less than £20 price range. It is located in the city centre. It is near Café Rouge. Its customer rating is low.
name[The Mill], eatType[restaurant], food[English], priceRange[less than £20], customer rating[low], area[city centre], familyFriendly[yes], near[Café Rouge]	The Mill is a family-friendly English restaurant with a price range of less than £20. It has a low customer rating and is located in the city centre near Café Rouge.
name[The Mill], eatType[restaurant], food[English], priceRange[less than £20], customer rating[low], area[riverside], familyFriendly[no], near[Café Rouge]	The Mill is a low-priced restaurant near Café Rouge.
name[The Mill], eatType[restaurant], food[English], priceRange[less than £20], customer rating[low], area[riverside], familyFriendly[yes], near[Café Rouge]	The Mill is a family friendly restaurant with a price range of less than £20. It is located near Café Rouge in the riverside area and has a low customer rating.
name[The Mill], eatType[restaurant], food[English], priceRange[moderate], area[city centre], familyFriendly[no], near[Raja Indian Cuisine]	The Mill is a restaurant providing English food in the moderate price range. It is located in the city centre. It is near Raja Indian Cuisine.
name[The Mill], eatType[restaurant], food[English], priceRange[moderate], area[city centre], familyFriendly[yes], near[Raja Indian Cuisine]	The Mill is a moderately priced, kid friendly English restaurant in the city centre near Raja Indian Cuisine.
name[The Mill], eatType[restaurant], food[English], priceRange[moderate], area[riverside], familyFriendly[no], near[Raja Indian Cuisine]	The Mill is a restaurant providing English food in the moderate price range. It is located in the riverside. It is near Raja Indian Cuisine.
name[The Mill], eatType[restaurant], food[English], priceRange[moderate], area[riverside], familyFriendly[yes], near[Raja Indian Cuisine]	The Mill is a moderately priced, kid friendly English restaurant in the riverside area near Raja Indian Cuisine.
name[The Mill], eatType[restaurant], food[English], priceRange[moderate], customer rating[1 out of 5], area[city centre], familyFriendly[no], near[Café Rouge]	The Mill is a restaurant providing English food in the moderate price range. It is located in the city centre. It is near Café Rouge. Its customer rating is 1 out of 5.
name[The Mill], eatType[restaurant], food[English], priceRange[moderate], customer rating[1 out of 5], area[city centre], familyFriendly[yes], near[Café Rouge]	The Mill is a moderately priced English restaurant in the city centre near Café Rouge. It is kid friendly and has a customer rating of 1 out of 5.
name[The Mill], eatType[restaurant], food[English], priceRange[moderate], customer rating[1 out of 5], area[riverside], familyFriendly[no], near[Café Rouge]	The Mill is a restaurant providing English food in the moderate price range. It is located in the riverside. It is near Café Rouge. Its customer rating is 1 out of 5.
name[The Mill], eatType[restaurant], food[English], priceRange[moderate], customer rating[1 out of 5], area[riverside], familyFriendly[yes], near[Café Rouge]	The Mill is a family friendly restaurant located near Café Rouge.
name[The Mill], eatType[restaurant], food[English], priceRange[moderate], customer rating[3 out of 5], area[city centre], familyFriendly[no], near[Café Rouge]	The Mill is a restaurant providing English food in the moderate price range. It is located in the city centre. It is near Café Rouge. Its customer rating is 3 out of 5.
name[The Mill], eatType[restaurant], food[English], priceRange[moderate], customer rating[3 out of 5], area[city centre], familyFriendly[yes], near[Café Rouge]	The Mill is a restaurant providing English food in the moderate price range. It is located in the city centre. It is near Café Rouge. Its customer rating is 3 out of 5.
name[The Mill], eatType[restaurant], food[English], priceRange[moderate], customer rating[3 out of 5], area[riverside], familyFriendly[no], near[Café Rouge]	The Mill is a restaurant providing English food in the moderate price range. It is located in the riverside. It is near Café Rouge. Its customer rating is 3 out of 5.
name[The Mill], eatType[restaurant], food[English], priceRange[moderate], customer rating[3 out of 5], area[riverside], familyFriendly[yes], near[Café Rouge]	The Mill is a moderately priced, kid friendly English restaurant in the riverside area near Café Rouge with a customer rating of 3 out of 5.
name[The Mill], eatType[restaurant], food[English], priceRange[more than £30], area[riverside], familyFriendly[yes], near[Raja Indian Cuisine]	The Mill is a restaurant providing English food in the more than £30 price range. It is located in the riverside. It is near Raja Indian Cuisine.
name[The Mill], eatType[restaurant], food[English], priceRange[more than £30], customer rating[high], area[city centre], familyFriendly[no], near[Café Rouge]	The Mill is a restaurant providing English food in the more than £30 price range. It is located in the city centre. It is near Café Rouge. Its customer rating is high.
name[The Mill], eatType[restaurant], food[English], priceRange[more than £30], customer rating[high], area[city centre], familyFriendly[yes], near[Café Rouge]	The Mill is a children friendly English restaurant with a high customer rating and a price range of more than £30. It is located in the city centre near Café Rouge.
name[The Mill], eatType[restaurant], food[English], priceRange[more than £30], customer rating[high], area[riverside], familyFriendly[no], near[Café Rouge]	The Mill is a restaurant providing English food in the more than £30 price range. It is located in the riverside. It is near Café Rouge. Its customer rating is high.
name[The Mill], eatType[restaurant], food[English], priceRange[more than £30], customer rating[high], area[riverside], familyFriendly[yes], near[Café Rouge]	The Mill is a family friendly restaurant located near Café Rouge.
name[The Mill], eatType[restaurant], food[Fast food], priceRange[£20-25], area[riverside], familyFriendly[yes], near[Raja Indian Cuisine]	The Mill is a kid friendly fast food restaurant in the riverside area near Raja Indian Cuisine with a price range of £20-25.
name[The Mill], eatType[restaurant], food[Fast food], priceRange[cheap], area[riverside], familyFriendly[yes], near[Raja Indian Cuisine]	The Mill is a cheap, family friendly, fast food restaurant in the riverside area near Raja Indian Cuisine.
name[The Phoenix], eatType[pub], food[Fast food], priceRange[cheap], area[riverside], familyFriendly[yes], near[Raja Indian Cuisine]	The Phoenix is a cheap, family friendly, fast food pub in the riverside area near Raja Indian Cuisine.
name[The Phoenix], eatType[pub], food[Fast food], priceRange[high], area[city centre], familyFriendly[no], near[Raja Indian Cuisine]	The Phoenix is a high priced fast food pub near Raja Indian Cuisine in the city centre. It is not child friendly.
name[The Phoenix], eatType[pub], food[Fast food], priceRange[high], area[city centre], familyFriendly[yes], near[Raja Indian Cuisine]	The Phoenix is a children friendly fast food pub in the city centre near Raja Indian Cuisine with a high price range.
name[The Phoenix], eatType[pub], food[Fast food], priceRange[high], area[riverside], familyFriendly[no], near[Raja Indian Cuisine]	The Phoenix is a high priced fast food pub in the riverside area near Raja Indian Cuisine. It is not children friendly.
name[The Phoenix], eatType[pub], food[Fast food], priceRange[high], area[riverside], familyFriendly[yes], near[Raja Indian Cuisine]	The Phoenix is a high priced, child friendly, fast food pub in the riverside area near Raja Indian Cuisine.
name[The Phoenix], eatType[pub], food[Fast food], priceRange[less than £20], area[city centre], familyFriendly[no], near[Raja Indian Cuisine]	The Phoenix is a non-family-friendly fast food pub in the city centre near Raja Indian Cuisine with a price range less than £20.
name[The Phoenix], eatType[pub], food[Fast food], priceRange[less than £20], area[city centre], familyFriendly[yes], near[Raja Indian Cuisine]	The Phoenix is a family-friendly fast food pub in the city centre near Raja Indian Cuisine with a price range less than £20.
name[The Phoenix], eatType[pub], food[Fast food], priceRange[less than £20], area[riverside], familyFriendly[no], near[Raja Indian Cuisine]	The Phoenix is a non-family-friendly pub that serves fast food for less than £20. It is located in the riverside area near Raja Indian Cuisine.
name[The Phoenix], eatType[pub], food[Fast food], priceRange[less than £20], area[riverside], familyFriendly[yes], near[Raja Indian Cuisine]	The Phoenix is a cheap, family friendly, fast food pub near Raja Indian Cuisine in the riverside area.
name[The Phoenix], eatType[pub], food[Fast food], priceRange[moderate], area[city centre], familyFriendly[no], near[Raja Indian Cuisine]	The Phoenix is a moderately priced fast food pub in the city centre near Raja Indian Cuisine. It is not kid friendly.
name[The Phoenix], eatType[pub], food[Fast food], priceRange[moderate], area[city centre], familyFriendly[yes], near[Raja Indian Cuisine]	The Phoenix is a moderately priced, kid friendly, fast food pub near Raja Indian Cuisine in the city centre.
name[The Phoenix], eatType[pub], food[Fast food], priceRange[moderate], area[riverside], familyFriendly[no], near[Raja Indian Cuisine]	The Phoenix is a moderately priced fast food pub in the riverside area near Raja Indian Cuisine. It is not kid friendly.
name[The Phoenix], eatType[pub], food[Fast food], priceRange[moderate], area[riverside], familyFriendly[yes], near[Raja Indian Cuisine]	The Phoenix is a moderately priced, kid friendly, fast food pub in the riverside area near Raja Indian Cuisine.
name[The Phoenix], eatType[pub], food[Fast food], priceRange[moderate], customer rating[3 out of 5], area[riverside], familyFriendly[yes], near[Café Sicilia]	The Phoenix is a moderately priced, kid friendly, fast food pub near Café Sicilia in the riverside area with a customer rating of 3 out of 5.
name[The Phoenix], eatType[pub], food[Fast food], priceRange[more than £30], area[riverside], familyFriendly[yes], near[Raja Indian Cuisine]	The Phoenix is a children friendly fast food pub in riverside near Raja Indian Cuisine with a price range of more than £30.
name[The Phoenix], eatType[pub], food[Fast food], priceRange[more than £30], customer rating[high], area[city centre], familyFriendly[no], near[Café Sicilia]	The Phoenix is a fast food pub located in the city centre near Café Sicilia. It has a high customer rating and a price range of more than £30. It is not children friendly.
name[The Phoenix], eatType[pub], food[Fast food], priceRange[more than £30], customer rating[high], area[city centre], familyFriendly[yes], near[Café Sicilia]	The Phoenix is a children friendly fast food pub in the city centre near Café Sicilia with a high customer rating and a price range of more than £30.
name[The Phoenix], eatType[pub], food[Fast food], priceRange[more than £30], customer rating[high], area[riverside], familyFriendly[no], near[Café Sicilia]	The Phoenix is a riverside fast food pub near Café Sicilia. It has a high customer rating and a price range of more than £30. It is not children friendly.
name[The Phoenix], eatType[pub], food[Fast food], priceRange[more than £30], customer rating[high], area[riverside], familyFriendly[yes], near[Café Sicilia]	The Phoenix is a children friendly fast food pub with a high customer rating and a price range of more than £30. It is located in the riverside area near Café Sicilia.
name[The Phoenix], eatType[pub], food[French], priceRange[£20-25], area[riverside], familyFriendly[yes], near[Raja Indian Cuisine]	The Phoenix is a kid friendly French pub in the riverside area near Raja Indian Cuisine with a price range of £20-25.
name[The Phoenix], eatType[pub], food[French], priceRange[£20-25], customer rating[3 out of 5], area[city centre], familyFriendly[no], near[Café Sicilia]	The Phoenix is a French pub located near Café Sicilia in the city centre. It has a customer rating of 3 out of 5 and a price range of £20-25. It is not kids friendly.
name[The Phoenix], eatType[pub], food[French], priceRange[£20-25], customer rating[3 out of 5], area[city centre], familyFriendly[yes], near[Café Sicilia]	The Phoenix is a kid friendly French pub located near Café Sicilia in the city centre. It has a customer rating of 3 out of 5 and a price range of £20-25.
name[The Phoenix], eatType[pub], food[French], priceRange[£20-25], customer rating[3 out of 5], area[riverside], familyFriendly[no], near[Café Sicilia]	The Phoenix is a French pub near Café Sicilia in the riverside area. It is not kid friendly, has a customer rating of 3 out of 5 and a price range of £20-25.
name[The Phoenix], eatType[pub], food[French], priceRange[£20-25], customer rating[3 out of 5], area[riverside], familyFriendly[yes], near[Café Sicilia]	The Phoenix is a family-friendly, mid-priced pub located near Café Sicilia.
name[The Phoenix], eatType[pub], food[French], priceRange[£20-25], customer rating[3 out of 5], area[riverside], familyFriendly[yes], near[Crowne Plaza Hotel]	The Phoenix is a kid friendly French pub near the Crowne Plaza Hotel in the riverside area with a price range of £20-25 and a customer rating of 3 out of 5.
name[The Phoenix], eatType[pub], food[French], priceRange[£20-25], customer rating[high], area[city centre], familyFriendly[no], near[Crowne Plaza Hotel]	The Phoenix is a French pub near the Crowne Plaza Hotel in the city centre. It has a high customer rating and a price range of £20-25. It is not kids friendly.
name[The Phoenix], eatType[pub], food[French], priceRange[£20-25], customer rating[high], area[city centre], familyFriendly[yes], near[Crowne Plaza Hotel]	The Phoenix is a kid friendly French pub in the city centre near Crowne Plaza Hotel with a high customer rating and a price range of £20-25.
name[The Phoenix], eatType[pub], food[French], priceRange[£20-25], customer rating[high], area[riverside], familyFriendly[no], near[Crowne Plaza Hotel]	The Phoenix is a French pub near the Crowne Plaza Hotel in the riverside area. It is not kid friendly, has a high customer rating and a price range of £20-25.
name[The Phoenix], eatType[pub], food[French], priceRange[£20-25], customer rating[high], area[riverside], familyFriendly[yes], near[Crowne Plaza Hotel]	The Phoenix is a kid friendly French pub in the riverside area near the Crowne Plaza Hotel with a high customer rating and a price range of £20-25.
name[The Phoenix], eatType[pub], food[French], priceRange[cheap], area[riverside], familyFriendly[yes], near[Raja Indian Cuisine]	The Phoenix is a cheap, family friendly French pub in the riverside area near Raja Indian Cuisine.
name[The Phoenix], eatType[pub], food[French], priceRange[cheap], customer rating[5 out of 5], area[city centre], familyFriendly[no], near[Crowne Plaza Hotel]	The Phoenix is a cheap French pub near the Crowne Plaza Hotel in the city centre. It is not family-friendly and has a customer rating of 5 out of 5.
name[The Phoenix], eatType[pub], food[French], priceRange[cheap], customer rating[5 out of 5], area[city centre], familyFriendly[yes], near[Crowne Plaza Hotel]	The Phoenix is a cheap, family-friendly, French pub near the Crowne Plaza Hotel in the city centre with a customer rating of 5 out of 5.
name[The Phoenix], eatType[pub], food[French], priceRange[cheap], customer rating[5 out of 5], area[riverside], familyFriendly[no], near[Crowne Plaza Hotel]	The Phoenix is a cheap French pub in the riverside area near the Crowne Plaza Hotel. It is not family-friendly and has a customer rating of 5 out of 5.
name[The Phoenix], eatType[pub], food[French], priceRange[cheap], customer rating[5 out of 5], area[riverside], familyFriendly[yes], near[Crowne Plaza Hotel]	The Phoenix is a cheap, family friendly, French pub in the riverside area near the Crowne Plaza Hotel with a customer rating of 5 out of 5.
name[The Phoenix], eatType[pub], food[French], priceRange[high], area[riverside], familyFriendly[yes], near[Raja Indian Cuisine]	The Phoenix is a high priced, child friendly French pub in the riverside area near Raja Indian Cuisine.
name[The Phoenix], eatType[pub], food[French], priceRange[high], customer rating[3 out of 5], area[city centre], familyFriendly[no], near[Crowne Plaza Hotel]	The Phoenix is a high priced French pub near the Crowne Plaza Hotel in the city centre. It is not child friendly and has a customer rating of 3 out of 5.
name[The Phoenix], eatType[pub], food[French], priceRange[high], customer rating[3 out of 5], area[city centre], familyFriendly[yes], near[Crowne Plaza Hotel]	The Phoenix is a children friendly, high priced French pub near the Crowne Plaza Hotel in the city centre with a customer rating of 3 out of 5.
name[The Phoenix], eatType[pub], food[French], priceRange[high], customer rating[3 out of 5], area[riverside], familyFriendly[no], near[Crowne Plaza Hotel]	The Phoenix is a high priced French pub near the Crowne Plaza Hotel in the riverside area. It is not child friendly and has a customer rating of 3 out of 5.
name[The Phoenix], eatType[pub], food[French], priceRange[high], customer rating[3 out of 5], area[riverside], familyFriendly[yes], near[Crowne Plaza Hotel]	The Phoenix is a high priced, three star, family friendly pub located near the Crowne Plaza Hotel.
name[The Phoenix], eatType[pub], food[French], priceRange[less than £20], customer rating[average], area[city centre], familyFriendly[no], near[Crowne Plaza Hotel]	The Phoenix is a French pub near the Crowne Plaza Hotel in the city centre. It is not family-friendly, has a price range of less than £20 and an average customer rating.
name[The Phoenix], eatType[pub], food[French], priceRange[less than £20], customer rating[average], area[city centre], familyFriendly[yes], near[Crowne Plaza Hotel]	The Phoenix is a family-friendly pub in the city centre near the Crowne Plaza Hotel. It serves French food for less than £20 and has an average customer rating.
name[The Phoenix], eatType[pub], food[French], priceRange[less than £20], customer rating[average], area[riverside], familyFriendly[no], near[Crowne Plaza Hotel]	The Phoenix is a French pub near the Crowne Plaza Hotel in the riverside area. It is not family-friendly, has a price range of less than £20 and an average customer rating.
name[The Phoenix], eatType[pub], food[French], priceRange[less than £20], customer rating[average], area[riverside], familyFriendly[yes], near[Crowne Plaza Hotel]	The Phoenix is a family friendly pub located near the Crowne Plaza Hotel in the riverside area. It serves French food for less than £20 and has an average customer rating.
name[The Phoenix], eatType[pub], food[French], priceRange[less than £20], customer rating[low], area[city centre], familyFriendly[no], near[Crowne Plaza Hotel]	The Phoenix is a French pub near the Crowne Plaza Hotel in the city centre. It is not family-friendly, has a low customer rating and a price range of less than £20.
name[The Phoenix], eatType[pub], food[French], priceRange[less than £20], customer rating[low], area[city centre], familyFriendly[yes], near[Crowne Plaza Hotel]	The Phoenix is a family-friendly French pub near the Crowne Plaza Hotel in the city centre. It has a low customer rating and a price range of less than £20.
name[The Phoenix], eatType[pub], food[French], priceRange[less than £20], customer rating[low], area[riverside], familyFriendly[no], near[Crowne Plaza Hotel]	The Phoenix is a French pub near the Crowne Plaza Hotel in the riverside area. It is not family-friendly and has a low customer rating. The price range is less than £20.
name[The Phoenix], eatType[pub], food[French], priceRange[less than £20], customer rating[low], area[riverside], familyFriendly[yes], near[Crowne Plaza Hotel]	The Phoenix is a family friendly pub that serves French food for less than £20. It is located near the Crown Plaza Hotel in the riverside area and has a low customer rating.
name[The Phoenix], eatType[pub], food[French], priceRange[moderate], customer rating[1 out of 5], area[city centre], familyFriendly[no], near[Crowne Plaza Hotel]	The Phoenix is a moderately priced French pub near the Crowne Plaza Hotel in the city centre. It is not kid friendly and has a customer rating of 1 out of 5.
name[The Phoenix], eatType[pub], food[French], priceRange[moderate], customer rating[1 out of 5], area[city centre], familyFriendly[yes], near[Crowne Plaza Hotel]	The Phoenix is a kid friendly French pub near the Crowne Plaza Hotel in the city centre. It has a moderate price range and a customer rating of 1 out of 5.
name[The Phoenix], eatType[pub], food[French], priceRange[moderate], customer rating[1 out of 5], area[riverside], familyFriendly[no], near[Crowne Plaza Hotel]	The Phoenix is a moderately priced French pub near the Crowne Plaza Hotel in the riverside area. It is not kid friendly and has a customer rating of 1 out of 5.
name[The Phoenix], eatType[pub], food[French], priceRange[moderate], customer rating[1 out of 5], area[riverside], familyFriendly[yes], near[Crowne Plaza Hotel]	The Phoenix is a moderately priced, kid friendly French pub in the riverside area near the Crown Plaza Hotel with a customer rating of 1 out of 5.
name[The Phoenix], eatType[pub], food[French], priceRange[more than £30], customer rating[5 out of 5], area[city centre], familyFriendly[no], near[Crowne Plaza Hotel]	The Phoenix is a French pub located in the city centre near the Crowne Plaza Hotel. It is not children friendly, has a price range of more than £30 and a customer rating of 5 out of 5.
name[The Phoenix], eatType[pub], food[French], priceRange[more than £30], customer rating[5 out of 5], area[city centre], familyFriendly[yes], near[Crowne Plaza Hotel]	The Phoenix is a children friendly French pub in the city centre near the Crowne Plaza Hotel with a price range of more than £30 and a customer rating of 5 out of 5.
name[The Phoenix], eatType[pub], food[French], priceRange[more than £30], customer rating[5 out of 5], area[riverside], familyFriendly[no], near[Crowne Plaza Hotel]	The Phoenix is a French pub in the riverside area near the Crowne Plaza Hotel. It is not children friendly, has a price range of more than £30 and a customer rating of 5 out of 5.
name[The Phoenix], eatType[pub], food[French], priceRange[more than £30], customer rating[5 out of 5], area[riverside], familyFriendly[yes], near[Crowne Plaza Hotel]	Near the Crowne Plaza Hotel in the riverside area is The Phoenix. It is a children friendly, French pub with a price range of more than £30 and a customer rating of 5 out of 5.
name[The Phoenix], eatType[pub], food[French], priceRange[more than £30], customer rating[low], area[city centre], familyFriendly[no], near[Crowne Plaza Hotel]	The Phoenix is a French pub near the Crowne Plaza Hotel in the city centre. It has a low customer rating, is not child friendly, and costs more than £30.
name[The Phoenix], eatType[pub], food[French], priceRange[more than £30], customer rating[low], area[city centre], familyFriendly[yes], near[Crowne Plaza Hotel]	The Phoenix is a child friendly French pub in the city centre near the Crowne Plaza Hotel. It has a low customer rating and a price range of more than £30.
name[The Phoenix], eatType[pub], food[French], priceRange[more than £30], customer rating[low], area[riverside], familyFriendly[no], near[Crowne Plaza Hotel]	The Phoenix is a French pub near the Crowne Plaza Hotel in the riverside area. It has a low customer rating, is not child friendly, and costs more than £30.
name[The Phoenix], eatType[pub], food[French], priceRange[more than £30], customer rating[low], area[riverside], familyFriendly[yes], near[Crowne Plaza Hotel]	The Phoenix is a high priced, one star, family friendly pub near the Crown Plaza Hotel.
name[The Phoenix], eatType[restaurant], food[Fast food], priceRange[cheap], area[riverside], familyFriendly[yes], near[Raja Indian Cuisine]	The Phoenix is a cheap, family friendly fast food restaurant in the riverside area near Raja Indian Cuisine.
name[The Phoenix], eatType[restaurant], food[Fast food], priceRange[high], area[city centre], familyFriendly[no], near[Raja Indian Cuisine]	The Phoenix is a high priced fast food restaurant in the city centre near Raja Indian Cuisine. It is not child friendly.
name[The Phoenix], eatType[restaurant], food[Fast food], priceRange[high], area[city centre], familyFriendly[yes], near[Raja Indian Cuisine]	The Phoenix is a children friendly fast food restaurant in the city centre near Raja Indian Cuisine with a high price range.
name[The Phoenix], eatType[restaurant], food[Fast food], priceRange[high], area[riverside], familyFriendly[no], near[Raja Indian Cuisine]	The Phoenix is a high priced fast food restaurant in the riverside area near Raja Indian Cuisine. It is not children friendly.
name[The Phoenix], eatType[restaurant], food[Fast food], priceRange[high], area[riverside], familyFriendly[yes], near[Raja Indian Cuisine]	The Phoenix is a children friendly fast food restaurant in the riverside area near Raja Indian Cuisine with a high price range.
name[The Phoenix], eatType[restaurant], food[Fast food], priceRange[less than £20], area[city centre], familyFriendly[no], near[Raja Indian Cuisine]	The Phoenix is a fast food restaurant located in the city centre near Raja Indian Cuisine. It has a price range of less than £20 and is not family-friendly.
name[The Phoenix], eatType[restaurant], food[Fast food], priceRange[less than £20], area[city centre], familyFriendly[yes], near[Raja Indian Cuisine]	The Phoenix is a family-friendly fast food restaurant in the city centre near Raja Indian Cuisine with a price range less than £20.
name[The Phoenix], eatType[restaurant], food[Fast food], priceRange[less than £20], area[riverside], familyFriendly[no], near[Raja Indian Cuisine]	The Phoenix is a restaurant providing take - away deliveries in the low price range. It is located near Raja Indian Cuisine.
name[The Phoenix], eatType[restaurant], food[Fast food], priceRange[less than £20], area[riverside], familyFriendly[yes], near[Raja Indian Cuisine]	The Phoenix is a family friendly fast food restaurant in the riverside area near Raja Indian Cuisine with a price range less than £20.
name[The Phoenix], eatType[restaurant], food[Fast food], priceRange[moderate], area[city centre], familyFriendly[no], near[Raja Indian Cuisine]	The Phoenix is a moderately priced fast food restaurant in the city centre near Raja Indian Cuisine. It is not kid friendly.
name[The Phoenix], eatType[restaurant], food[Fast food], priceRange[moderate], area[city centre], familyFriendly[yes], near[Raja Indian Cuisine]	The Phoenix is a moderately priced, kid friendly fast food restaurant in the city centre near Raja Indian Cuisine.
name[The Phoenix], eatType[restaurant], food[Fast food], priceRange[moderate], area[riverside], familyFriendly[no], near[Raja Indian Cuisine]	The Phoenix is a moderately priced fast food restaurant in riverside near Raja Indian Cuisine. It is not kid friendly.
name[The Phoenix], eatType[restaurant], food[Fast food], priceRange[moderate], area[riverside], familyFriendly[yes], near[Raja Indian Cuisine]	The Phoenix is a moderately priced, kid friendly fast food restaurant in the riverside area near Raja Indian Cuisine.
name[The Phoenix], eatType[restaurant], food[Fast food], priceRange[more than £30], area[riverside], familyFriendly[yes], near[Raja Indian Cuisine]	The Phoenix is a children friendly fast food restaurant in the riverside area near Raja Indian Cuisine with a price range of more than £30.
name[The Phoenix], eatType[restaurant], food[French], priceRange[£20-25], area[riverside], familyFriendly[yes], near[Raja Indian Cuisine]	The Phoenix is a kid friendly French restaurant in the riverside area near Raja Indian Cuisine with a price range of £20-25.
name[The Phoenix], eatType[restaurant], food[French], priceRange[cheap], area[riverside], familyFriendly[yes], near[Raja Indian Cuisine]	The Phoenix is a cheap, family friendly French restaurant in the riverside area near Raja Indian Cuisine.
name[The Phoenix], eatType[restaurant], food[French], priceRange[high], area[riverside], familyFriendly[yes], near[Raja Indian Cuisine]	The Phoenix is a high priced, child friendly French restaurant in the riverside area near Raja Indian Cuisine.
name[The Phoenix], eatType[restaurant], food[Indian], priceRange[£20-25], customer rating[high], area[city centre], familyFriendly[no], near[Crowne Plaza Hotel]	The Phoenix is a restaurant providing Indian food in the £20-25 price range. It is located in the city centre. It is near Crowne Plaza Hotel. Its customer rating is high.
name[The Phoenix], eatType[restaurant], food[Indian], priceRange[£20-25], customer rating[high], area[city centre], familyFriendly[yes], near[Crowne Plaza Hotel]	The Phoenix is a restaurant providing Indian food in the £20-25 price range. It is located in the city centre. It is near Crowne Plaza Hotel. Its customer rating is high.
name[The Phoenix], eatType[restaurant], food[Indian], priceRange[£20-25], customer rating[high], area[riverside], familyFriendly[no], near[Crowne Plaza Hotel]	The Phoenix is a restaurant providing Indian food in the £20-25 price range. It is located in the riverside. It is near Crowne Plaza Hotel. Its customer rating is high.
name[The Phoenix], eatType[restaurant], food[Indian], priceRange[£20-25], customer rating[high], area[riverside], familyFriendly[yes], near[Crowne Plaza Hotel]	The Phoenix is a restaurant providing Indian food in the £20-25 price range. It is located in the riverside. It is near Crowne Plaza Hotel. Its customer rating is high.
name[The Phoenix], eatType[restaurant], food[Indian], priceRange[cheap], customer rating[5 out of 5], area[city centre], familyFriendly[no], near[Crowne Plaza Hotel]	The Phoenix is a restaurant providing Indian food in the cheap price range. It is located in the city centre. It is near Crowne Plaza Hotel. Its customer rating is 5 out of 5.
name[The Phoenix], eatType[restaurant], food[Indian], priceRange[cheap], customer rating[5 out of 5], area[city centre], familyFriendly[yes], near[Crowne Plaza Hotel]	The Phoenix is a restaurant providing Indian food in the cheap price range. It is located in the city centre. It is near Crowne Plaza Hotel. Its customer rating is 5 out of 5.
name[The Phoenix], eatType[restaurant], food[Indian], priceRange[cheap], customer rating[5 out of 5], area[riverside], familyFriendly[no], near[Crowne Plaza Hotel]	The Phoenix is a restaurant providing Indian food in the cheap price range. It is located in the riverside. It is near Crowne Plaza Hotel. Its customer rating is 5 out of 5.
name[The Phoenix], eatType[restaurant], food[Indian], priceRange[cheap], customer rating[5 out of 5], area[riverside], familyFriendly[no], near[Express by Holiday Inn]	The Phoenix is a restaurant providing Indian food in the cheap price range. It is located in the riverside. It is near Express by Holiday Inn. Its customer rating is 5 out of 5.
name[The Phoenix], eatType[restaurant], food[Indian], priceRange[cheap], customer rating[5 out of 5], area[riverside], familyFriendly[yes], near[Express by Holiday Inn]	The Phoenix is a restaurant providing Indian food in the cheap price range. It is located in the riverside. It is near Express by Holiday Inn. Its customer rating is 5 out of 5.
name[The Phoenix], eatType[restaurant], food[Indian], priceRange[cheap], customer rating[average], area[city centre], familyFriendly[no], near[Express by Holiday Inn]	The Phoenix is a restaurant providing Indian food in the cheap price range. It is located in the city centre. It is near Express by Holiday Inn. Its customer rating is average.
name[The Plough], eatType[pub], food[Chinese], priceRange[£20-25], area[riverside], familyFriendly[yes], near[Raja Indian Cuisine]	The Plough is a pub that provides Chinese food in the £20-25 price range. It is located in the riverside. It is near Raja Indian Cuisine.
name[The Plough], eatType[pub], food[Chinese], priceRange[cheap], area[riverside], familyFriendly[yes], near[Raja Indian Cuisine]	The Plough is a pub that provides Chinese food in the cheap price range. It is located in the riverside. It is near Raja Indian Cuisine.
name[The Plough], eatType[pub], food[Chinese], priceRange[high], area[city centre], familyFriendly[no], near[Raja Indian Cuisine]	The Plough is a pub that provides Chinese food in the high price range. It is located in the city centre. It is near Raja Indian Cuisine.
name[The Plough], eatType[pub], food[Chinese], priceRange[high], area[city centre], familyFriendly[yes], near[Raja Indian Cuisine]	The Plough is a pub that provides Chinese food in the high price range. It is located in the city centre. It is near Raja Indian Cuisine.
name[The Plough], eatType[pub], food[Chinese], priceRange[high], area[riverside], familyFriendly[no], near[Raja Indian Cuisine]	The Plough is a pub that provides Chinese food in the high price range. It is located in the riverside. It is near Raja Indian Cuisine.
name[The Plough], eatType[pub], food[Chinese], priceRange[high], area[riverside], familyFriendly[yes], near[Raja Indian Cuisine]	The Plough is a pub that provides Chinese food in the high price range. It is located in the riverside. It is near Raja Indian Cuisine.
name[The Plough], eatType[pub], food[Chinese], priceRange[less than £20], area[city centre], familyFriendly[no], near[Raja Indian Cuisine]	The Plough is a pub that provides Chinese food in the less than £20 price range. It is located in the city centre. It is near Raja Indian Cuisine.
name[The Plough], eatType[restaurant], food[Chinese], priceRange[£20-25], area[riverside], familyFriendly[yes], near[Raja Indian Cuisine]	The Plough is a restaurant providing Chinese food in the £20-25 price range. It is located in the riverside. It is near Raja Indian Cuisine.
name[The Plough], eatType[restaurant], food[Chinese], priceRange[cheap], area[riverside], familyFriendly[yes], near[Raja Indian Cuisine]	The Plough is a cheap, family friendly Chinese restaurant in the riverside area near Raja Indian Cuisine.
name[The Plough], eatType[restaurant], food[Chinese], priceRange[high], area[city centre], familyFriendly[no], near[Raja Indian Cuisine]	The Plough is a restaurant providing Chinese food in the high price range. It is located in the city centre. It is near Raja Indian Cuisine.
name[The Plough], eatType[restaurant], food[Chinese], priceRange[high], area[city centre], familyFriendly[yes], near[Raja Indian Cuisine]	The Plough is a high priced, child friendly Chinese restaurant located near Raja Indian Cuisine in the city centre.
name[The Plough], eatType[restaurant], food[Chinese], priceRange[high], area[riverside], familyFriendly[no], near[Raja Indian Cuisine]	The Plough is a restaurant providing Chinese food in the high price range. It is located in the riverside. It is near Raja Indian Cuisine.
name[The Plough], eatType[restaurant], food[Chinese], priceRange[high], area[riverside], familyFriendly[yes], near[Raja Indian Cuisine]	The Plough is a high priced, child friendly Chinese restaurant in the riverside area near Raja Indian Cuisine.
name[The Plough], eatType[restaurant], food[Chinese], priceRange[less than £20], area[city centre], familyFriendly[no], near[Raja Indian Cuisine]	The Plough is a restaurant providing Chinese food in the less than £20 price range. It is located in the city centre. It is near Raja Indian Cuisine.
name[The Punter], eatType[pub], food[Chinese], priceRange[less than £20], area[city centre], familyFriendly[yes], near[Raja Indian Cuisine]	The Punter is a pub that provides Chinese food in the less than £20 price range. It is located in the city centre. It is near Raja Indian Cuisine.
name[The Punter], eatType[pub], food[Chinese], priceRange[less than £20], area[riverside], familyFriendly[no], near[Raja Indian Cuisine]	The Punter is a pub that provides Chinese food in the less than £20 price range. It is located in the riverside. It is near Raja Indian Cuisine.
name[The Punter], eatType[pub], food[Chinese], priceRange[less than £20], area[riverside], familyFriendly[yes], near[Raja Indian Cuisine]	The Punter is a pub that provides Chinese food in the less than £20 price range. It is located in the riverside. It is near Raja Indian Cuisine.
name[The Punter], eatType[pub], food[Chinese], priceRange[moderate], area[city centre], familyFriendly[no], near[Raja Indian Cuisine]	The Punter is a pub that provides Chinese food in the moderate price range. It is located in the city centre. It is near Raja Indian Cuisine.
name[The Punter], eatType[pub], food[Chinese], priceRange[moderate], area[city centre], familyFriendly[yes], near[Raja Indian Cuisine]	The Punter is a pub that provides Chinese food in the moderate price range. It is located in the city centre. It is near Raja Indian Cuisine.
name[The Punter], eatType[pub], food[Chinese], priceRange[moderate], area[riverside], familyFriendly[no], near[Raja Indian Cuisine]	The Punter is a pub that provides Chinese food in the moderate price range. It is located in the riverside. It is near Raja Indian Cuisine.
name[The Punter], eatType[pub], food[Chinese], priceRange[moderate], area[riverside], familyFriendly[yes], near[Raja Indian Cuisine]	The Punter is a pub that provides Chinese food in the moderate price range. It is located in the riverside. It is near Raja Indian Cuisine.
name[The Punter], eatType[pub], food[Chinese], priceRange[more than £30], area[riverside], familyFriendly[yes], near[Raja Indian Cuisine]	The Punter is a pub that provides Chinese food in the more than £30 price range. It is located in the riverside. It is near Raja Indian Cuisine.
name[The Punter], eatType[pub], food[English], priceRange[£20-25], area[riverside], familyFriendly[yes], near[Raja Indian Cuisine]	The Punter is a kid friendly English pub in the riverside area near Raja Indian Cuisine with a price range of £20-25.
name[The Punter], eatType[pub], food[English], priceRange[cheap], area[riverside], familyFriendly[yes], near[Raja Indian Cuisine]	The Punter is a cheap, family friendly pub serving English food in the riverside area near Raja Indian Cuisine.
name[The Punter], eatType[pub], food[English], priceRange[high], area[city centre], familyFriendly[no], near[Raja Indian Cuisine]	The Punter is a high priced English pub near Raja Indian Cuisine in the city centre. It is not children friendly.
name[The Punter], eatType[pub], food[English], priceRange[high], area[city centre], familyFriendly[yes], near[Raja Indian Cuisine]	The Punter is a children friendly English pub near Raja Indian Cuisine in the city centre with a high price range.
name[The Punter], eatType[pub], food[English], priceRange[high], area[riverside], familyFriendly[no], near[Raja Indian Cuisine]	The Punter is a high priced English pub near Raja Indian Cuisine in riverside. It is not children friendly.
name[The Punter], eatType[pub], food[English], priceRange[high], area[riverside], familyFriendly[yes], near[Raja Indian Cuisine]	The Punter is a high priced, child friendly pub that serves English food. It is located in the riverside area near Raja Indian Cuisine.
name[The Punter], eatType[pub], food[Italian], priceRange[high], customer rating[average], area[city centre], familyFriendly[no], near[Rainbow Vegetarian Café]	The Punter is a high priced Italian pub near the Rainbow Vegetarian Café in the city centre. It has an average customer rating and is not child friendly.
name[The Punter], eatType[restaurant], food[Chinese], priceRange[less than £20], area[city centre], familyFriendly[yes], near[Raja Indian Cuisine]	The Punter is a family friendly Chinese restaurant in the city centre near Raja Indian Cuisine with a price range of less than £20.
name[The Punter], eatType[restaurant], food[Chinese], priceRange[less than £20], area[riverside], familyFriendly[no], near[Raja Indian Cuisine]	The Punter is a restaurant providing Chinese food in the less than £20 price range. It is located in the riverside. It is near Raja Indian Cuisine.
name[The Punter], eatType[restaurant], food[Chinese], priceRange[less than £20], area[riverside], familyFriendly[yes], near[Raja Indian Cuisine]	The Punter is a restaurant providing Chinese food in the less than £20 price range. It is located in the riverside. It is near Raja Indian Cuisine.
name[The Punter], eatType[restaurant], food[Chinese], priceRange[moderate], area[city centre], familyFriendly[no], near[Raja Indian Cuisine]	The Punter is a restaurant providing Chinese food in the moderate price range. It is located in the city centre. It is near Raja Indian Cuisine.
name[The Punter], eatType[restaurant], food[Chinese], priceRange[moderate], area[city centre], familyFriendly[yes], near[Raja Indian Cuisine]	The Punter is a restaurant providing Chinese food in the moderate price range. It is located in the city centre. It is near Raja Indian Cuisine.
name[The Punter], eatType[restaurant], food[Chinese], priceRange[moderate], area[riverside], familyFriendly[no], near[Raja Indian Cuisine]	The Punter is a restaurant providing Chinese food in the moderate price range. It is located in the riverside. It is near Raja Indian Cuisine.
name[The Punter], eatType[restaurant], food[Chinese], priceRange[moderate], area[riverside], familyFriendly[yes], near[Raja Indian Cuisine]	The Punter is a restaurant providing Chinese food in the moderate price range. It is located in the riverside. It is near Raja Indian Cuisine.
name[The Punter], eatType[restaurant], food[Chinese], priceRange[more than £30], area[riverside], familyFriendly[yes], near[Raja Indian Cuisine]	The Punter is a restaurant providing Chinese food in the more than £30 price range. It is located in the riverside. It is near Raja Indian Cuisine.
name[The Punter], eatType[restaurant], food[English], priceRange[£20-25], area[riverside], familyFriendly[yes], near[Raja Indian Cuisine]	The Punter is a restaurant providing English food in the £20-25 price range. It is located in the riverside. It is near Raja Indian Cuisine.
name[The Punter], eatType[restaurant], food[English], priceRange[cheap], area[riverside], familyFriendly[yes], near[Raja Indian Cuisine]	The Punter is a cheap, family friendly, English restaurant in the riverside area near Raja Indian Cuisine.
name[The Punter], eatType[restaurant], food[English], priceRange[high], area[city centre], familyFriendly[no], near[Raja Indian Cuisine]	The Punter is a restaurant providing English food in the high price range. It is located in the city centre. It is near Raja Indian Cuisine.
name[The Punter], eatType[restaurant], food[English], priceRange[high], area[city centre], familyFriendly[yes], near[Raja Indian Cuisine]	The Punter is a restaurant providing English food in the high price range. It is located in the city centre. It is near Raja Indian Cuisine.
name[The Punter], eatType[restaurant], food[English], priceRange[high], area[riverside], familyFriendly[no], near[Raja Indian Cuisine]	The Punter is a restaurant providing English food in the high price range. It is located in the riverside. It is near Raja Indian Cuisine.
name[The Punter], eatType[restaurant], food[English], priceRange[high], area[riverside], familyFriendly[yes], near[Raja Indian Cuisine]	The Punter is a child friendly English restaurant in the riverside area near Raja Indian Cuisine with a high price range.
name[The Punter], eatType[restaurant], food[Indian], priceRange[cheap], customer rating[average], area[city centre], familyFriendly[yes], near[Express by Holiday Inn]	The Punter is a restaurant providing Indian food in the cheap price range. It is located in the city centre. It is near Express by Holiday Inn. Its customer rating is average.
name[The Punter], eatType[restaurant], food[Indian], priceRange[cheap], customer rating[average], area[riverside], familyFriendly[no], near[Express by Holiday Inn]	The Punter is a restaurant providing Indian food in the cheap price range. It is located in the riverside. It is near Express by Holiday Inn. Its customer rating is average.
name[The Punter], eatType[restaurant], food[Indian], priceRange[cheap], customer rating[average], area[riverside], familyFriendly[yes], near[Express by Holiday Inn]	The Punter is a restaurant providing Indian food in the cheap price range. It is located in the riverside. It is near Express by Holiday Inn. Its customer rating is average.
name[The Punter], eatType[restaurant], food[Indian], priceRange[high], customer rating[1 out of 5], area[city centre], familyFriendly[no], near[Express by Holiday Inn]	The Punter is a restaurant providing Indian food in the high price range. It is located in the city centre. It is near Express by Holiday Inn. Its customer rating is 1 out of 5.
name[The Punter], eatType[restaurant], food[Indian], priceRange[high], customer rating[1 out of 5], area[city centre], familyFriendly[yes], near[Express by Holiday Inn]	The Punter is a restaurant providing Indian food in the high price range. It is located in the city centre. It is near Express by Holiday Inn. Its customer rating is 1 out of 5.
name[The Punter], eatType[restaurant], food[Indian], priceRange[high], customer rating[1 out of 5], area[riverside], familyFriendly[no], near[Express by Holiday Inn]	The Punter is a restaurant providing Indian food in the high price range. It is located in the riverside. It is near Express by Holiday Inn. Its customer rating is 1 out of 5.
name[The Punter], eatType[restaurant], food[Indian], priceRange[high], customer rating[1 out of 5], area[riverside], familyFriendly[yes], near[Express by Holiday Inn]	The Punter is a restaurant providing Indian food in the high price range. It is located in the riverside. It is near Express by Holiday Inn. Its customer rating is 1 out of 5.
name[The Punter], eatType[restaurant], food[Indian], priceRange[high], customer rating[average], area[city centre], familyFriendly[no], near[Express by Holiday Inn]	The Punter is a restaurant providing Indian food in the high price range. It is located in the city centre. It is near Express by Holiday Inn. Its customer rating is average.
name[The Punter], eatType[restaurant], food[Indian], priceRange[high], customer rating[average], area[city centre], familyFriendly[yes], near[Express by Holiday Inn]	The Punter is a restaurant providing Indian food in the high price range. It is located in the city centre. It is near Express by Holiday Inn. Its customer rating is average.
name[The Punter], eatType[restaurant], food[Indian], priceRange[high], customer rating[average], area[riverside], familyFriendly[no], near[Express by Holiday Inn]	The Punter is a restaurant providing Indian food in the high price range. It is located in the riverside. It is near Express by Holiday Inn. Its customer rating is average.
name[The Punter], eatType[restaurant], food[Indian], priceRange[high], customer rating[average], area[riverside], familyFriendly[yes], near[Express by Holiday Inn]	The Punter is a restaurant providing Indian food in the high price range. It is located in the riverside. It is near Express by Holiday Inn. Its customer rating is average.
name[The Punter], eatType[restaurant], food[Indian], priceRange[less than £20], customer rating[low], area[city centre], familyFriendly[no], near[Express by Holiday Inn]	The Punter is a restaurant providing Indian food in the less than £20 price range. It is located in the city centre. It is near Express by Holiday Inn. Its customer rating is low.
name[The Punter], eatType[restaurant], food[Indian], priceRange[less than £20], customer rating[low], area[city centre], familyFriendly[yes], near[Express by Holiday Inn]	The Punter is a restaurant providing Indian food in the less than £20 price range. It is located in the city centre. It is near Express by Holiday Inn. Its customer rating is low.
name[The Punter], eatType[restaurant], food[Indian], priceRange[less than £20], customer rating[low], area[riverside], familyFriendly[no], near[Express by Holiday Inn]	The Punter is a restaurant providing Indian food in the less than £20 price range. It is located in the riverside. It is near Express by Holiday Inn. Its customer rating is low.
name[The Punter], eatType[restaurant], food[Indian], priceRange[less than £20], customer rating[low], area[riverside], familyFriendly[yes], near[Express by Holiday Inn]	The Punter is a restaurant providing Indian food in the less than £20 price range. It is located in the riverside. It is near Express by Holiday Inn. Its customer rating is low.
name[The Punter], eatType[restaurant], food[Indian], priceRange[moderate], customer rating[1 out of 5], area[city centre], familyFriendly[no], near[Express by Holiday Inn]	The Punter is a restaurant providing Indian food in the moderate price range. It is located in the city centre. It is near Express by Holiday Inn. Its customer rating is 1 out of 5.
name[The Punter], eatType[restaurant], food[Indian], priceRange[moderate], customer rating[1 out of 5], area[city centre], familyFriendly[yes], near[Express by Holiday Inn]	The Punter is a restaurant providing Indian food in the moderate price range. It is located in the city centre. It is near Express by Holiday Inn. Its customer rating is 1 out of 5.
name[The Punter], eatType[restaurant], food[Indian], priceRange[moderate], customer rating[1 out of 5], area[riverside], familyFriendly[no], near[Express by Holiday Inn]	The Punter is a restaurant providing Indian food in the moderate price range. It is located in the riverside. It is near Express by Holiday Inn. Its customer rating is 1 out of 5.
name[The Punter], eatType[restaurant], food[Indian], priceRange[moderate], customer rating[1 out of 5], area[riverside], familyFriendly[yes], near[Express by Holiday Inn]	The Punter is a restaurant providing Indian food in the moderate price range. It is located in the riverside. It is near Express by Holiday Inn. Its customer rating is 1 out of 5.
name[The Punter], eatType[restaurant], food[Indian], priceRange[moderate], customer rating[3 out of 5], area[city centre], familyFriendly[no], near[Express by Holiday Inn]	The Punter is a restaurant providing Indian food in the moderate price range. It is located in the city centre. It is near Express by Holiday Inn. Its customer rating is 3 out of 5.
name[The Punter], eatType[restaurant], food[Indian], priceRange[moderate], customer rating[3 out of 5], area[city centre], familyFriendly[yes], near[Express by Holiday Inn]	The Punter is a restaurant providing Indian food in the moderate price range. It is located in the city centre. It is near Express by Holiday Inn. Its customer rating is 3 out of 5.
name[The Punter], eatType[restaurant], food[Indian], priceRange[moderate], customer rating[3 out of 5], area[riverside], familyFriendly[no], near[Express by Holiday Inn]	The Punter is a restaurant providing Indian food in the moderate price range. It is located in the riverside. It is near Express by Holiday Inn. Its customer rating is 3 out of 5.
name[The Punter], eatType[restaurant], food[Indian], priceRange[moderate], customer rating[3 out of 5], area[riverside], familyFriendly[yes], near[Express by Holiday Inn]	The Punter is a restaurant providing Indian food in the moderate price range. It is located in the riverside. It is near Express by Holiday Inn. Its customer rating is 3 out of 5.
name[The Punter], eatType[restaurant], food[Indian], priceRange[more than £30], customer rating[high], area[city centre], familyFriendly[no], near[Express by Holiday Inn]	The Punter is a restaurant providing Indian food in the more than £30 price range. It is located in the city centre. It is near Express by Holiday Inn. Its customer rating is high.
name[The Punter], eatType[restaurant], food[Indian], priceRange[more than £30], customer rating[high], area[city centre], familyFriendly[yes], near[Express by Holiday Inn]	The Punter is a restaurant providing Indian food in the more than £30 price range. It is located in the city centre. It is near Express by Holiday Inn. Its customer rating is high.
name[The Punter], eatType[restaurant], food[Indian], priceRange[more than £30], customer rating[high], area[riverside], familyFriendly[no], near[Express by Holiday Inn]	The Punter is a restaurant providing Indian food in the more than £30 price range. It is located in the riverside. It is near Express by Holiday Inn. Its customer rating is high.
name[The Punter], eatType[restaurant], food[Indian], priceRange[more than £30], customer rating[high], area[riverside], familyFriendly[yes], near[Express by Holiday Inn]	The Punter is a restaurant providing Indian food in the more than £30 price range. It is located in the riverside. It is near Express by Holiday Inn. Its customer rating is high.
name[The Punter], eatType[restaurant], food[Italian], priceRange[£20-25], customer rating[high], area[city centre], familyFriendly[no], near[Express by Holiday Inn]	The Punter is a restaurant providing Italian food in the £20-25 price range. It is located in the city centre. It is near Express by Holiday Inn. Its customer rating is high.
name[The Punter], eatType[restaurant], food[Italian], priceRange[£20-25], customer rating[high], area[city centre], familyFriendly[yes], near[Express by Holiday Inn]	The Punter is a kid friendly Italian restaurant in the city centre near Express by Holiday Inn with a high customer rating and a price range of £20-25.
name[The Punter], eatType[restaurant], food[Italian], priceRange[£20-25], customer rating[high], area[riverside], familyFriendly[no], near[Express by Holiday Inn]	The Punter is a riverside Italian restaurant near Express by Holiday Inn. It has a high customer rating and a price range of £20-25. It is not kids friendly.
name[The Punter], eatType[restaurant], food[Italian], priceRange[£20-25], customer rating[high], area[riverside], familyFriendly[yes], near[Express by Holiday Inn]	The Punter is a restaurant providing Italian food in the £20-25 price range. It is located in the riverside. It is near Express by Holiday Inn. Its customer rating is high.
name[The Punter], eatType[restaurant], food[Italian], priceRange[cheap], customer rating[5 out of 5], area[city centre], familyFriendly[no], near[Express by Holiday Inn]	The Punter is a cheap Italian restaurant near Express by Holiday Inn in the city centre. It is not family-friendly and has a customer rating of 5 out of 5.
name[The Punter], eatType[restaurant], food[Italian], priceRange[cheap], customer rating[5 out of 5], area[city centre], familyFriendly[no], near[Rainbow Vegetarian Café]	The Punter is a cheap Italian restaurant near the Rainbow Vegetarian Café in the city centre. It has a customer rating of 5 out of 5 and is not family-friendly.
name[The Punter], eatType[restaurant], food[Italian], priceRange[cheap], customer rating[5 out of 5], area[city centre], familyFriendly[yes], near[Rainbow Vegetarian Café]	The Punter is a cheap, family-friendly Italian restaurant in the city centre near the Rainbow Vegetarian Café with a customer rating of 5 out of 5.
name[The Punter], eatType[restaurant], food[Italian], priceRange[cheap], customer rating[5 out of 5], area[riverside], familyFriendly[no], near[Rainbow Vegetarian Café]	The Punter is a cheap Italian restaurant near the Rainbow Vegetarian Café in the riverside area. It has a customer rating of 5 out of 5 and is not family-friendly.
name[The Punter], eatType[restaurant], food[Italian], priceRange[cheap], customer rating[5 out of 5], area[riverside], familyFriendly[yes], near[Rainbow Vegetarian Café]	The Punter is a cheap family friendly Italian restaurant in the riverside area near Rainbow Vegetarian Café with a customer rating of 5 out of 5.
name[The Punter], eatType[restaurant], food[Italian], priceRange[cheap], customer rating[average], area[city centre], familyFriendly[no], near[Rainbow Vegetarian Café]	The Punter is a cheap Italian restaurant near the Rainbow Vegetarian Café in the city centre. It has an average customer rating and is not family-friendly.
name[The Punter], eatType[restaurant], food[Italian], priceRange[cheap], customer rating[average], area[city centre], familyFriendly[yes], near[Rainbow Vegetarian Café]	The Punter is a cheap, family-friendly Italian restaurant in the city centre near the Rainbow Vegetarian Café with an average customer rating.
name[The Punter], eatType[restaurant], food[Italian], priceRange[cheap], customer rating[average], area[riverside], familyFriendly[no], near[Rainbow Vegetarian Café]	The Punter is a cheap Italian restaurant near the Rainbow Vegetarian Café in the riverside area. It is not family-friendly and has an average customer rating.
name[The Punter], eatType[restaurant], food[Italian], priceRange[cheap], customer rating[average], area[riverside], familyFriendly[yes], near[Rainbow Vegetarian Café]	The Punter is a cheap, family friendly Italian restaurant with an average customer rating. It is located in the riverside area near Rainbow Vegetarian Café.
name[The Punter], eatType[restaurant], food[Italian], priceRange[high], customer rating[1 out of 5], area[city centre], familyFriendly[no], near[Rainbow Vegetarian Café]	The Punter is a high priced Italian restaurant near the Rainbow Vegetarian Café in the city centre. It is not child friendly and has a customer rating of 1 out of 5.
name[The Punter], eatType[restaurant], food[Italian], priceRange[high], customer rating[1 out of 5], area[city centre], familyFriendly[yes], near[Rainbow Vegetarian Café]	The Punter is a family-friendly Italian restaurant in the city centre near the Rainbow Vegetarian Café with a high price range and a customer rating of 1 out of 5.
name[The Punter], eatType[restaurant], food[Italian], priceRange[high], customer rating[1 out of 5], area[riverside], familyFriendly[no], near[Rainbow Vegetarian Café]	The Punter is a high priced Italian restaurant near the Rainbow Vegetarian Café in the riverside area. It is not child friendly and has a customer rating of 1 out of 5.
name[The Punter], eatType[restaurant], food[Italian], priceRange[high], customer rating[1 out of 5], area[riverside], familyFriendly[yes], near[Rainbow Vegetarian Café]	The Punter is a family friendly Italian restaurant near the Rainbow Vegetarian Café in the riverside area. It has a high price range and a customer rating of 1 out of 5.
name[The Vaults], eatType[pub], food[French], priceRange[high], area[riverside], familyFriendly[yes], near[Raja Indian Cuisine]	The Vaults is a high priced, child friendly, French pub near Raja Indian Cuisine in the riverside area.
name[The Vaults], eatType[pub], food[French], priceRange[less than £20], area[city centre], familyFriendly[no], near[Raja Indian Cuisine]	The Vaults is a non-family-friendly French pub in the city centre near Raja Indian Cuisine with a price range of less than £20.
name[The Vaults], eatType[pub], food[French], priceRange[less than £20], area[city centre], familyFriendly[yes], near[Raja Indian Cuisine]	The Vaults is a family-friendly French pub in the city centre near Raja Indian Cuisine with a price range of less than £20.
name[The Vaults], eatType[pub], food[French], priceRange[less than £20], area[riverside], familyFriendly[no], near[Raja Indian Cuisine]	The Vaults is a low-priced pub located near Raja Indian Cuisine.
name[The Vaults], eatType[pub], food[French], priceRange[less than £20], area[riverside], familyFriendly[yes], near[Raja Indian Cuisine]	The Vaults is a family friendly pub that serves French food for less than £20. It is located in the riverside area near Raja Indian Cuisine.
name[The Vaults], eatType[pub], food[French], priceRange[moderate], area[city centre], familyFriendly[no], near[Raja Indian Cuisine]	The Vaults is a moderately priced French pub near Raja Indian Cuisine in the city centre. It is not kid friendly.
name[The Vaults], eatType[pub], food[French], priceRange[moderate], area[city centre], familyFriendly[yes], near[Raja Indian Cuisine]	The Vaults is a moderately priced, kid friendly French pub near Raja Indian Cuisine in the city centre.
name[The Vaults], eatType[pub], food[French], priceRange[moderate], area[riverside], familyFriendly[no], near[Raja Indian Cuisine]	The Vaults is a moderately priced French pub in the riverside area near Raja Indian Cuisine. It is not kid friendly.
name[The Vaults], eatType[pub], food[French], priceRange[moderate], area[riverside], familyFriendly[yes], near[Raja Indian Cuisine]	The Vaults is a moderately priced, kid friendly pub serving French food in the riverside area near Raja Indian Cuisine.
name[The Vaults], eatType[pub], food[French], priceRange[more than £30], area[city centre], familyFriendly[no], near[Raja Indian Cuisine]	The Vaults is a French pub located in the city centre near Raja Indian Cuisine. It is not children friendly and costs more than £30.
name[The Vaults], eatType[pub], food[French], priceRange[more than £30], area[city centre], familyFriendly[yes], near[Raja Indian Cuisine]	The Vaults is a children friendly French pub in the city centre near Raja Indian Cuisine with a price range of more than £30.
name[The Vaults], eatType[pub], food[French], priceRange[more than £30], area[riverside], familyFriendly[no], near[Raja Indian Cuisine]	The Vaults is a French pub in the riverside area near Raja Indian Cuisine. It is not children friendly and costs more than £30.
name[The Vaults], eatType[pub], food[French], priceRange[more than £30], area[riverside], familyFriendly[yes], near[Raja Indian Cuisine]	The Vaults is a children friendly French pub in the riverside area near Raja Indian Cuisine with a price range of more than £30.
name[The Vaults], eatType[pub], food[Indian], priceRange[£20-25], area[riverside], familyFriendly[yes], near[Raja Indian Cuisine]	The Vaults is a pub that provides Indian food in the £20-25 price range. It is located in the riverside. It is near Raja Indian Cuisine.
name[The Vaults], eatType[pub], food[Indian], priceRange[cheap], area[riverside], familyFriendly[yes], near[Raja Indian Cuisine]	The Vaults is a pub that provides Indian food in the cheap price range. It is located in the riverside. It is near Raja Indian Cuisine.
name[The Vaults], eatType[pub], food[Indian], priceRange[high], area[city centre], familyFriendly[no], near[Raja Indian Cuisine]	The Vaults is a pub providing Indian food in the high price range. It is located in the city centre. It is near Raja Indian Cuisine.
name[The Vaults], eatType[pub], food[Indian], priceRange[high], area[city centre], familyFriendly[yes], near[Raja Indian Cuisine]	The Vaults is a pub providing Indian food in the high price range. It is located in the city centre. It is near Raja Indian Cuisine.
name[The Vaults], eatType[pub], food[Italian], priceRange[high], customer rating[average], area[city centre], familyFriendly[no], near[Rainbow Vegetarian Café]	The Vaults is a high priced Italian pub near the Rainbow Vegetarian Café in the city centre. It has an average customer rating and is not children friendly.
name[The Vaults], eatType[pub], food[Italian], priceRange[high], customer rating[average], area[city centre], familyFriendly[yes], near[Rainbow Vegetarian Café]	The Vaults is an Italian pub near the Rainbow Vegetarian Café in the city centre. It is children friendly, has a high price range and an average customer rating.
name[The Vaults], eatType[pub], food[Italian], priceRange[high], customer rating[average], area[riverside], familyFriendly[no], near[Rainbow Vegetarian Café]	The Vaults is a high priced Italian pub near the Rainbow Vegetarian Café in the riverside area. It is not children friendly and has an average customer rating.
name[The Vaults], eatType[pub], food[Italian], priceRange[high], customer rating[average], area[riverside], familyFriendly[yes], near[Rainbow Vegetarian Café]	The Vaults is an expensive, three star, family friendly pub located near the Rainbow Vegetarian Café.
name[The Vaults], eatType[pub], food[Italian], priceRange[less than £20], customer rating[low], area[city centre], familyFriendly[no], near[Rainbow Vegetarian Café]	The Vaults is an Italian pub located near the Rainbow Vegetarian Café in the city centre. It is not family-friendly, has a low customer rating and a price range of less than £20.
name[The Vaults], eatType[pub], food[Italian], priceRange[less than £20], customer rating[low], area[city centre], familyFriendly[yes], near[Rainbow Vegetarian Café]	The Vaults is a family-friendly Italian pub in the city centre near the Rainbow Vegetarian Café with a low customer rating and a price range of less than £20.
name[The Vaults], eatType[pub], food[Italian], priceRange[less than £20], customer rating[low], area[riverside], familyFriendly[no], near[Rainbow Vegetarian Café]	The Vaults is a cheap, one-star pub located near the Rainbow Vegetarian Café. It is not family friendly.
name[The Vaults], eatType[pub], food[Italian], priceRange[less than £20], customer rating[low], area[riverside], familyFriendly[yes], near[Rainbow Vegetarian Café]	The Vaults is a family friendly Italian pub near the Rainbow Vegetarian Café in the riverside area with a low customer rating and a price range of less than £20.
name[The Vaults], eatType[pub], food[Italian], priceRange[moderate], customer rating[1 out of 5], area[city centre], familyFriendly[no], near[Rainbow Vegetarian Café]	The Vaults is a moderately priced Italian pub near the Rainbow Vegetarian Café in the city centre. It is not kid friendly and has a customer rating of 1 out of 5.
name[The Vaults], eatType[pub], food[Italian], priceRange[moderate], customer rating[1 out of 5], area[city centre], familyFriendly[yes], near[Rainbow Vegetarian Café]	The Vaults is a kid friendly Italian pub near the Rainbow Vegetarian Café in the city centre with a moderate price range and a customer rating of 1 out of 5.
name[The Vaults], eatType[pub], food[Italian], priceRange[moderate], customer rating[1 out of 5], area[riverside], familyFriendly[no], near[Rainbow Vegetarian Café]	The Vaults is a moderately priced Italian pub near the Rainbow Vegetarian Café in the riverside area. It is not kid friendly and has a customer rating of 1 out of 5.
name[The Vaults], eatType[pub], food[Italian], priceRange[moderate], customer rating[1 out of 5], area[riverside], familyFriendly[yes], near[Rainbow Vegetarian Café]	Near the Rainbow Vegetarian Café in the riverside area, there is a moderately priced Italian pub called The Vaults. It is kid friendly and has a customer rating of 1 out of 5.
name[The Vaults], eatType[pub], food[Italian], priceRange[moderate], customer rating[3 out of 5], area[city centre], familyFriendly[no], near[Rainbow Vegetarian Café]	The Vaults is a moderately priced Italian pub near the Rainbow Vegetarian Café in the city centre. It is not kid friendly and has a customer rating of 3 out of 5.
name[The Vaults], eatType[pub], food[Italian], priceRange[moderate], customer rating[3 out of 5], area[city centre], familyFriendly[yes], near[Rainbow Vegetarian Café]	The Vaults is a kid friendly Italian pub located near the Rainbow Vegetarian Café in the city centre. It has a moderate price range and a customer rating of 3 out of 5.
name[The Vaults], eatType[pub], food[Italian], priceRange[moderate], customer rating[3 out of 5], area[riverside], familyFriendly[no], near[Rainbow Vegetarian Café]	The Vaults is a moderately priced Italian pub in the riverside area near the Rainbow Vegetarian Café. It is not kid friendly and has a customer rating of 3 out of 5.
name[The Vaults], eatType[pub], food[Italian], priceRange[moderate], customer rating[3 out of 5], area[riverside], familyFriendly[yes], near[Rainbow Vegetarian Café]	The Vaults is a family friendly Italian pub in the riverside area near the Rainbow Vegetarian Café. It has a moderate price range and a customer rating of 3 out of 5.
name[The Vaults], eatType[pub], food[Italian], priceRange[more than £30], customer rating[high], area[city centre], familyFriendly[no], near[Rainbow Vegetarian Café]	The Vaults is an Italian pub near the Rainbow Vegetarian Café in the city centre. It has a high customer rating and a price range of more than £30. It is not children friendly.
name[The Vaults], eatType[pub], food[Italian], priceRange[more than £30], customer rating[high], area[city centre], familyFriendly[yes], near[Rainbow Vegetarian Café]	The Vaults is a child friendly Italian pub in the city centre near the Rainbow Vegetarian Café with a high customer rating and a price range of more than £30.
name[The Vaults], eatType[pub], food[Italian], priceRange[more than £30], customer rating[high], area[riverside], familyFriendly[no], near[Rainbow Vegetarian Café]	The Vaults is an Italian pub near the Rainbow Vegetarian Café in the riverside area. It has a high customer rating and a price range of more than £30. It is not children friendly.
name[The Vaults], eatType[pub], food[Italian], priceRange[more than £30], customer rating[high], area[riverside], familyFriendly[yes], near[Rainbow Vegetarian Café]	The Vaults is a family friendly Italian pub with a high customer rating and a price range of more than £30. It is located in the riverside area near the Rainbow Vegetarian Café.
name[The Vaults], eatType[pub], food[Japanese], priceRange[£20-25], customer rating[3 out of 5], area[city centre], familyFriendly[no], near[Rainbow Vegetarian Café]	The Vaults is a Japanese pub located near the Rainbow Vegetarian Café in the city centre. It is not kid friendly, has a customer rating of 3 out of 5 and a price range of £20-25.
name[The Vaults], eatType[pub], food[Japanese], priceRange[£20-25], customer rating[3 out of 5], area[city centre], familyFriendly[yes], near[Rainbow Vegetarian Café]	The Vaults is a kid friendly Japanese pub in the city centre near the Rainbow Vegetarian Café with a customer rating of 3 out of 5 and a price range of £20-25.
name[The Vaults], eatType[pub], food[Japanese], priceRange[£20-25], customer rating[3 out of 5], area[riverside], familyFriendly[no], near[Rainbow Vegetarian Café]	The Vaults is a Japanese pub near the Rainbow Vegetarian Café in the riverside area. It is not kid friendly, has a customer rating of 3 out of 5 and a price range of £20-25.
name[The Vaults], eatType[pub], food[Japanese], priceRange[£20-25], customer rating[3 out of 5], area[riverside], familyFriendly[yes], near[Rainbow Vegetarian Café]	The Vaults is a kids friendly Japanese pub near Rainbow Vegetarian Café in the riverside area with a customer rating of 3 out of 5 and a price range of £20-25.
name[The Vaults], eatType[pub], food[Japanese], priceRange[£20-25], customer rating[high], area[city centre], familyFriendly[no], near[Rainbow Vegetarian Café]	The Vaults is a Japanese pub near the Rainbow Vegetarian Café in the city centre with a high customer rating and a price range of £20-25. It is not kids friendly.
name[The Vaults], eatType[pub], food[Japanese], priceRange[£20-25], customer rating[high], area[city centre], familyFriendly[yes], near[Rainbow Vegetarian Café]	The Vaults is a kid friendly Japanese pub in the city centre near the Rainbow Vegetarian Café with a high customer rating and a price range of £20-25.
name[The Vaults], eatType[pub], food[Japanese], priceRange[£20-25], customer rating[high], area[riverside], familyFriendly[no], near[Rainbow Vegetarian Café]	The Vaults is a Japanese pub near the Rainbow Vegetarian Café in the riverside area. It has a high customer rating and a price range of £20-25. It is not kids friendly.
name[The Vaults], eatType[pub], food[Japanese], priceRange[£20-25], customer rating[high], area[riverside], familyFriendly[no], near[Raja Indian Cuisine]	The Vaults is a Japanese pub near Raja Indian Cuisine in the riverside area. It has a high customer rating, is not kid friendly, and has a price range of £20-25.
name[The Vaults], eatType[pub], food[Japanese], priceRange[£20-25], customer rating[high], area[riverside], familyFriendly[yes], near[Raja Indian Cuisine]	The Vaults is a kid friendly Japanese pub in the riverside area near Raja Indian Cuisine with a high customer rating and a price range of £20-25.
name[The Vaults], eatType[pub], food[Japanese], priceRange[cheap], customer rating[5 out of 5], area[city centre], familyFriendly[no], near[Raja Indian Cuisine]	The Vaults is a cheap Japanese pub in the city centre near Raja Indian Cuisine. It has a customer rating of 5 out of 5 and is not family-friendly.
name[The Vaults], eatType[pub], food[Japanese], priceRange[cheap], customer rating[5 out of 5], area[city centre], familyFriendly[yes], near[Raja Indian Cuisine]	The Vaults is a cheap, family-friendly, Japanese pub in the city centre near Raja Indian Cuisine with a customer rating of 5 out of 5.
name[The Vaults], eatType[pub], food[Japanese], priceRange[cheap], customer rating[5 out of 5], area[riverside], familyFriendly[no], near[Raja Indian Cuisine]	The Vaults is a cheap Japanese pub in the riverside area near Raja Indian Cuisine. It has a customer rating of 5 out of 5 and is not family-friendly.
name[The Vaults], eatType[pub], food[Japanese], priceRange[cheap], customer rating[5 out of 5], area[riverside], familyFriendly[yes], near[Raja Indian Cuisine]	The Vaults is a cheap, family friendly, Japanese pub in the riverside area near Raja Indian Cuisine with a customer rating of 5 out of 5.
name[The Vaults], eatType[pub], food[Japanese], priceRange[high], customer rating[3 out of 5], area[city centre], familyFriendly[no], near[Raja Indian Cuisine]	The Vaults is a high priced Japanese pub located in the city centre near Raja Indian Cuisine. It is not child friendly and has a customer rating of 3 out of 5.
name[The Vaults], eatType[pub], food[Japanese], priceRange[high], customer rating[3 out of 5], area[city centre], familyFriendly[yes], near[Raja Indian Cuisine]	The Vaults is a children friendly Japanese pub in the city centre near Raja Indian Cuisine with a high price range and a customer rating of 3 out of 5.
name[The Vaults], eatType[pub], food[Japanese], priceRange[high], customer rating[3 out of 5], area[riverside], familyFriendly[no], near[Raja Indian Cuisine]	The Vaults is a high priced Japanese pub in the riverside area near Raja Indian Cuisine. It is not children friendly and has a customer rating of 3 out of 5.
name[The Vaults], eatType[pub], food[Japanese], priceRange[high], customer rating[3 out of 5], area[riverside], familyFriendly[yes], near[Raja Indian Cuisine]	The Vaults is a children friendly Japanese pub in the riverside area near Raja Indian Cuisine with a customer rating of 3 out of 5 and a high price range.
name[The Vaults], eatType[pub], food[Japanese], priceRange[less than £20], customer rating[average], area[city centre], familyFriendly[no], near[Raja Indian Cuisine]	The Vaults is a pub that serves Japanese food for less than £20. It is located in the city centre near Raja Indian Cuisine. It has an average customer rating and is not family-friendly.
name[The Vaults], eatType[pub], food[Japanese], priceRange[less than £20], customer rating[average], area[city centre], familyFriendly[yes], near[Raja Indian Cuisine]	The Vaults is a family-friendly Japanese pub in the city centre near Raja Indian Cuisine with an average customer rating and a price range of less than £20.
name[The Vaults], eatType[pub], food[Japanese], priceRange[less than £20], customer rating[average], area[riverside], familyFriendly[no], near[Raja Indian Cuisine]	The Vaults is a Japanese pub near Raja Indian Cuisine in the riverside area. It is not family-friendly, has a price range of less than £20 and an average customer rating.
name[The Vaults], eatType[pub], food[Japanese], priceRange[less than £20], customer rating[average], area[riverside], familyFriendly[yes], near[Raja Indian Cuisine]	The Vaults is a cheap, family friendly pub located near Raja Indian Cuisine.
name[The Vaults], eatType[pub], food[Japanese], priceRange[less than £20], customer rating[low], area[city centre], familyFriendly[no], near[Raja Indian Cuisine]	The Vaults is a Japanese pub near Raja Indian Cuisine in the city centre. It is not family-friendly, has a low customer rating, and a price range of less than £20.
name[The Vaults], eatType[pub], food[Japanese], priceRange[less than £20], customer rating[low], area[city centre], familyFriendly[yes], near[Raja Indian Cuisine]	The Vaults is a family-friendly Japanese pub in the city centre near Raja Indian Cuisine with a low customer rating and a price range of less than £20.
name[The Vaults], eatType[pub], food[Japanese], priceRange[less than £20], customer rating[low], area[riverside], familyFriendly[no], near[Raja Indian Cuisine]	The Vaults is a Japanese pub near Raja Indian Cuisine in the riverside area. It is not family-friendly and has a low customer rating. The price range is less than £20.
name[The Vaults], eatType[pub], food[Japanese], priceRange[less than £20], customer rating[low], area[riverside], familyFriendly[yes], near[Raja Indian Cuisine]	The Vaults is a family friendly Japanese pub near Raja Indian Cuisine in the riverside area. It has a low customer rating and a price range of less than £20.
name[The Vaults], eatType[pub], food[Japanese], priceRange[moderate], customer rating[1 out of 5], area[city centre], familyFriendly[no], near[Raja Indian Cuisine]	The Vaults is a moderately priced Japanese pub in the city centre near Raja Indian Cuisine. It is not kid friendly and has a customer rating of 1 out of 5.
name[The Vaults], eatType[pub], food[Japanese], priceRange[moderate], customer rating[1 out of 5], area[city centre], familyFriendly[yes], near[Raja Indian Cuisine]	The Vaults is a kid friendly Japanese pub in the city centre near Raja Indian Cuisine with a moderate price range and a customer rating of 1 out of 5.
name[The Vaults], eatType[restaurant], food[French], priceRange[high], area[riverside], familyFriendly[yes], near[Raja Indian Cuisine]	The Vaults is a high priced, child friendly French restaurant in the riverside area near Raja Indian Cuisine.
name[The Vaults], eatType[restaurant], food[French], priceRange[less than £20], area[city centre], familyFriendly[no], near[Raja Indian Cuisine]	The Vaults is a restaurant providing French food in the less than £20 price range. It is located in the city centre. It is near Raja Indian Cuisine.
name[The Vaults], eatType[restaurant], food[French], priceRange[less than £20], area[city centre], familyFriendly[yes], near[Raja Indian Cuisine]	The Vaults is a family-friendly French restaurant in the city centre near Raja Indian Cuisine with a price range less than £20.
name[The Vaults], eatType[restaurant], food[French], priceRange[less than £20], area[riverside], familyFriendly[no], near[Raja Indian Cuisine]	The Vaults is a low-priced restaurant located near Raja Indian Cuisine.
name[The Vaults], eatType[restaurant], food[French], priceRange[less than £20], area[riverside], familyFriendly[yes], near[Raja Indian Cuisine]	The Vaults is a family friendly French restaurant in the riverside area near Raja Indian Cuisine with a price range of less than £20.
name[The Vaults], eatType[restaurant], food[French], priceRange[moderate], area[city centre], familyFriendly[no], near[Raja Indian Cuisine]	The Vaults is a moderately priced French restaurant in the city centre near Raja Indian Cuisine. It is not kid friendly.
name[The Vaults], eatType[restaurant], food[French], priceRange[moderate], area[city centre], familyFriendly[yes], near[Raja Indian Cuisine]	The Vaults is a moderately priced, kid friendly French restaurant in the city centre near Raja Indian Cuisine.
name[The Vaults], eatType[restaurant], food[French], priceRange[moderate], area[riverside], familyFriendly[no], near[Raja Indian Cuisine]	The Vaults is a restaurant providing French food in the moderate price range. It is located in the riverside. It is near Raja Indian Cuisine.
name[The Vaults], eatType[restaurant], food[French], priceRange[moderate], area[riverside], familyFriendly[yes], near[Raja Indian Cuisine]	The Vaults is a moderately priced, kid friendly French restaurant in the riverside area near Raja Indian Cuisine.
name[The Vaults], eatType[restaurant], food[French], priceRange[more than £30], area[city centre], familyFriendly[no], near[Raja Indian Cuisine]	The Vaults is a restaurant providing French food in the more than £30 price range. It is located in the city centre. It is near Raja Indian Cuisine.
name[The Vaults], eatType[restaurant], food[French], priceRange[more than £30], area[city centre], familyFriendly[yes], near[Raja Indian Cuisine]	The Vaults is a children friendly French restaurant in the city centre near Raja Indian Cuisine with a price range of more than £30.
name[The Vaults], eatType[restaurant], food[French], priceRange[more than £30], area[riverside], familyFriendly[no], near[Raja Indian Cuisine]	The Vaults is a restaurant providing French food in the more than £30 price range. It is located in the riverside. It is near Raja Indian Cuisine.
name[The Vaults], eatType[restaurant], food[French], priceRange[more than £30], area[riverside], familyFriendly[yes], near[Raja Indian Cuisine]	The Vaults is a children friendly French restaurant in the riverside area near Raja Indian Cuisine with a price range of more than £30.
name[The Vaults], eatType[restaurant], food[Indian], priceRange[£20-25], area[riverside], familyFriendly[yes], near[Raja Indian Cuisine]	The Vaults is a kid friendly Indian restaurant in the riverside area near Raja Indian Cuisine with a price range of £20-25.
name[The Vaults], eatType[restaurant], food[Indian], priceRange[cheap], area[riverside], familyFriendly[yes], near[Raja Indian Cuisine]	The Vaults is a cheap, family friendly Indian restaurant in the riverside area near Raja Indian Cuisine.
name[The Vaults], eatType[restaurant], food[Indian], priceRange[high], area[city centre], familyFriendly[no], near[Raja Indian Cuisine]	The Vaults is a restaurant providing Indian food in the high price range. It is located in the city centre. It is near Raja Indian Cuisine.
name[The Vaults], eatType[restaurant], food[Indian], priceRange[high], area[city centre], familyFriendly[yes], near[Raja Indian Cuisine]	The Vaults is a high priced Indian restaurant in the city centre near Raja Indian Cuisine. It is children friendly.
name[The Waterman], eatType[pub], food[Indian], priceRange[high], area[city centre], familyFriendly[yes], near[Raja Indian Cuisine]	The Waterman is a pub providing Indian food in the high price range. It is located in the city centre. It is near Raja Indian Cuisine.
name[The Waterman], eatType[pub], food[Indian], priceRange[high], area[riverside], familyFriendly[no], near[Raja Indian Cuisine]	The Waterman is a pub providing Indian food in the high price range. It is located in the riverside. It is near Raja Indian Cuisine.
name[The Waterman], eatType[pub], food[Indian], priceRange[high], area[riverside], familyFriendly[yes], near[Raja Indian Cuisine]	The Waterman is a pub that provides Indian food in the high price range. It is located in the riverside. It is near Raja Indian Cuisine.
name[The Waterman], eatType[pub], food[Indian], priceRange[less than £20], area[city centre], familyFriendly[no], near[Raja Indian Cuisine]	The Waterman is a pub providing Indian food in the less than £20 price range. It is located in the city centre. It is near Raja Indian Cuisine.
name[The Waterman], eatType[pub], food[Indian], priceRange[less than £20], area[city centre], familyFriendly[yes], near[Raja Indian Cuisine]	The Waterman is a pub providing Indian food in the less than £20 price range. It is located in the city centre. It is near Raja Indian Cuisine.
name[The Waterman], eatType[pub], food[Indian], priceRange[less than £20], area[riverside], familyFriendly[no], near[Raja Indian Cuisine]	The Waterman is a pub providing Indian food in the less than £20 price range. It is located in the riverside. It is near Raja Indian Cuisine.
name[The Waterman], eatType[pub], food[Indian], priceRange[less than £20], area[riverside], familyFriendly[yes], near[Raja Indian Cuisine]	The Waterman is a pub providing Indian food in the less than £20 price range. It is located in the riverside. It is near Raja Indian Cuisine.
name[The Waterman], eatType[pub], food[Indian], priceRange[moderate], area[city centre], familyFriendly[no], near[Raja Indian Cuisine]	The Waterman is a pub providing Indian food in the moderate price range. It is located in the city centre. It is near Raja Indian Cuisine.
name[The Waterman], eatType[pub], food[Indian], priceRange[moderate], area[city centre], familyFriendly[yes], near[Raja Indian Cuisine]	The Waterman is a pub providing Indian food in the moderate price range. It is located in the city centre. It is near Raja Indian Cuisine.
name[The Waterman], eatType[pub], food[Indian], priceRange[moderate], area[riverside], familyFriendly[no], near[Raja Indian Cuisine]	The Waterman is a pub providing Indian food in the moderate price range. It is located in the riverside. It is near Raja Indian Cuisine.
name[The Waterman], eatType[pub], food[Indian], priceRange[moderate], area[riverside], familyFriendly[yes], near[Raja Indian Cuisine]	The Waterman is a pub providing Indian food in the moderate price range. It is located in the riverside. It is near Raja Indian Cuisine.
name[The Waterman], eatType[pub], food[Indian], priceRange[more than £30], area[riverside], familyFriendly[yes], near[Raja Indian Cuisine]	The Waterman is a pub providing Indian food in the more than £30 price range. It is located in the riverside. It is near Raja Indian Cuisine.
name[The Waterman], eatType[pub], food[Italian], priceRange[£20-25], area[riverside], familyFriendly[yes], near[Raja Indian Cuisine]	The Waterman is a kid friendly Italian pub in the riverside area near Raja Indian Cuisine with a price range of £20-25.
name[The Waterman], eatType[pub], food[Italian], priceRange[cheap], area[riverside], familyFriendly[yes], near[Raja Indian Cuisine]	The Waterman is a cheap, family friendly, Italian pub in the riverside area near Raja Indian Cuisine.
name[The Waterman], eatType[pub], food[Italian], priceRange[high], area[city centre], familyFriendly[no], near[Raja Indian Cuisine]	The Waterman is a high priced Italian pub near Raja Indian Cuisine in the city centre. It is not children friendly.
name[The Waterman], eatType[pub], food[Italian], priceRange[high], area[city centre], familyFriendly[yes], near[Raja Indian Cuisine]	The Waterman is a children friendly Italian pub in the city centre near Raja Indian Cuisine with a high price range.
name[The Waterman], eatType[pub], food[Italian], priceRange[high], area[riverside], familyFriendly[no], near[Raja Indian Cuisine]	The Waterman is an Italian pub near Raja Indian Cuisine in the riverside area. It has a high price range and is not children friendly.
name[The Waterman], eatType[pub], food[Italian], priceRange[high], area[riverside], familyFriendly[yes], near[Raja Indian Cuisine]	The Waterman is a children friendly, high priced Italian pub near Raja Indian Cuisine in the riverside area.
name[The Waterman], eatType[pub], food[Italian], priceRange[less than £20], area[city centre], familyFriendly[no], near[Raja Indian Cuisine]	The Waterman is a pub providing Italian food in the less than £20 price range. It is located in the city centre. It is near Raja Indian Cuisine.
name[The Waterman], eatType[pub], food[Italian], priceRange[less than £20], area[city centre], familyFriendly[yes], near[Raja Indian Cuisine]	The Waterman is a family-friendly Italian pub in the city centre near Raja Indian Cuisine with a price range of less than £20.
name[The Waterman], eatType[pub], food[Italian], priceRange[less than £20], area[riverside], familyFriendly[no], near[Raja Indian Cuisine]	The Waterman is a pub providing Italian food in the less than £20 price range. It is located in the riverside. It is near Raja Indian Cuisine.
name[The Waterman], eatType[restaurant], food[Indian], priceRange[high], area[city centre], familyFriendly[yes], near[Raja Indian Cuisine]	The Waterman is a restaurant providing Indian food in the high price range. It is located in the city centre. It is near Raja Indian Cuisine.
name[The Waterman], eatType[restaurant], food[Indian], priceRange[high], area[riverside], familyFriendly[no], near[Raja Indian Cuisine]	The Waterman is a restaurant providing Indian food in the high price range. It is located in the riverside. It is near Raja Indian Cuisine.
name[The Waterman], eatType[restaurant], food[Indian], priceRange[high], area[riverside], familyFriendly[yes], near[Raja Indian Cuisine]	The Waterman is a high priced Indian restaurant in Riverside near Raja Indian Cuisine. It is child friendly.
name[The Waterman], eatType[restaurant], food[Indian], priceRange[less than £20], area[city centre], familyFriendly[no], near[Raja Indian Cuisine]	The Waterman is a restaurant providing Indian food in the less than £20 price range. It is located in the city centre. It is near Raja Indian Cuisine.
name[The Waterman], eatType[restaurant], food[Indian], priceRange[less than £20], area[city centre], familyFriendly[yes], near[Raja Indian Cuisine]	The Waterman is a restaurant providing Indian food in the less than £20 price range. It is located in the city centre. It is near Raja Indian Cuisine.
name[The Waterman], eatType[restaurant], food[Indian], priceRange[less than £20], area[riverside], familyFriendly[no], near[Raja Indian Cuisine]	The Waterman is a restaurant providing Indian food in the less than £20 price range. It is located in the riverside. It is near Raja Indian Cuisine.
name[The Waterman], eatType[restaurant], food[Indian], priceRange[less than £20], area[riverside], familyFriendly[yes], near[Raja Indian Cuisine]	The Waterman is a restaurant providing Indian food in the less than £20 price range. It is located in the riverside. It is near Raja Indian Cuisine.
name[The Waterman], eatType[restaurant], food[Indian], priceRange[moderate], area[city centre], familyFriendly[no], near[Raja Indian Cuisine]	The Waterman is a restaurant providing Indian food in the moderate price range. It is located in the city centre. It is near Raja Indian Cuisine.
name[The Waterman], eatType[restaurant], food[Indian], priceRange[moderate], area[city centre], familyFriendly[yes], near[Raja Indian Cuisine]	The Waterman is a restaurant providing Indian food in the moderate price range. It is located in the city centre. It is near Raja Indian Cuisine.
name[The Waterman], eatType[restaurant], food[Indian], priceRange[moderate], area[riverside], familyFriendly[no], near[Raja Indian Cuisine]	The Waterman is a restaurant providing Indian food in the moderate price range. It is located in the riverside. It is near Raja Indian Cuisine.
name[The Waterman], eatType[restaurant], food[Indian], priceRange[moderate], area[riverside], familyFriendly[yes], near[Raja Indian Cuisine]	The Waterman is a restaurant providing Indian food in the moderate price range. It is located in the riverside. It is near Raja Indian Cuisine.
name[The Waterman], eatType[restaurant], food[Indian], priceRange[more than £30], area[riverside], familyFriendly[yes], near[Raja Indian Cuisine]	The Waterman is a restaurant providing Indian food in the more than £30 price range. It is located in the riverside. It is near Raja Indian Cuisine.
name[The Waterman], eatType[restaurant], food[Italian], priceRange[£20-25], area[riverside], familyFriendly[yes], near[Raja Indian Cuisine]	The Waterman is a kid friendly Italian restaurant in the riverside area near Raja Indian Cuisine with a price range of £20-25.
name[The Waterman], eatType[restaurant], food[Italian], priceRange[cheap], area[riverside], familyFriendly[yes], near[Raja Indian Cuisine]	The Waterman is a cheap, family friendly Italian restaurant in the riverside area near Raja Indian Cuisine.
name[The Waterman], eatType[restaurant], food[Italian], priceRange[high], area[city centre], familyFriendly[no], near[Raja Indian Cuisine]	The Waterman is a high priced Italian restaurant near Raja Indian Cuisine in the city centre. It is not children friendly.
name[The Waterman], eatType[restaurant], food[Italian], priceRange[high], area[city centre], familyFriendly[yes], near[Raja Indian Cuisine]	The Waterman is a children friendly Italian restaurant in the city centre near Raja Indian Cuisine with a high price range.
name[The Waterman], eatType[restaurant], food[Italian], priceRange[high], area[riverside], familyFriendly[no], near[Raja Indian Cuisine]	The Waterman is a high priced Italian restaurant in riverside near Raja Indian Cuisine. It is not children friendly.
name[The Waterman], eatType[restaurant], food[Italian], priceRange[high], area[riverside], familyFriendly[yes], near[Raja Indian Cuisine]	The Waterman is a children friendly Italian restaurant in the riverside area near Raja Indian Cuisine with a high price range.
name[The Waterman], eatType[restaurant], food[Italian], priceRange[less than £20], area[city centre], familyFriendly[no], near[Raja Indian Cuisine]	The Waterman is a restaurant providing Italian food in the less than £20 price range. It is located in the city centre. It is near Raja Indian Cuisine.
name[The Waterman], eatType[restaurant], food[Italian], priceRange[less than £20], area[city centre], familyFriendly[yes], near[Raja Indian Cuisine]	The Waterman is a family-friendly Italian restaurant in the city centre near Raja Indian Cuisine with a price range of less than £20.
name[The Waterman], eatType[restaurant], food[Italian], priceRange[less than £20], area[riverside], familyFriendly[no], near[Raja Indian Cuisine]	The Waterman is a restaurant providing Italian food in the less than £20 price range. It is located in the riverside. It is near Raja Indian Cuisine.
name[The Wrestlers], eatType[pub], food[Italian], priceRange[less than £20], area[riverside], familyFriendly[no], near[Raja Indian Cuisine]	The Wrestlers is an Italian pub near Raja Indian Cuisine in the riverside area. It has a price range of less than £20 and is not family-friendly.
name[The Wrestlers], eatType[pub], food[Italian], priceRange[less than £20], area[riverside], familyFriendly[yes], near[Raja Indian Cuisine]	The Wrestlers is a family friendly pub that serves Italian food for less than £20. It is located near Raja Indian Cuisine in the riverside area.
name[The Wrestlers], eatType[pub], food[Italian], priceRange[moderate], area[city centre], familyFriendly[no], near[Raja Indian Cuisine]	The Wrestlers is a moderately priced Italian pub near Raja Indian Cuisine in the city centre. It is not kid friendly.
name[The Wrestlers], eatType[pub], food[Italian], priceRange[moderate], area[city centre], familyFriendly[yes], near[Raja Indian Cuisine]	The Wrestlers is a kid friendly Italian pub in the city centre near Raja Indian Cuisine with a moderate price range.
name[The Wrestlers], eatType[pub], food[Italian], priceRange[moderate], area[riverside], familyFriendly[no], near[Raja Indian Cuisine]	The Wrestlers is a moderately priced Italian pub near Raja Indian Cuisine in riverside. It is not kid friendly.
name[The Wrestlers], eatType[pub], food[Italian], priceRange[moderate], area[riverside], familyFriendly[yes], near[Raja Indian Cuisine]	The Wrestlers is a moderately priced, kid friendly Italian pub near Raja Indian Cuisine in the riverside area.
name[The Wrestlers], eatType[pub], food[Italian], priceRange[more than £30], area[riverside], familyFriendly[yes], near[Raja Indian Cuisine]	The Wrestlers is a children friendly Italian pub in the riverside area near Raja Indian Cuisine with a price range of more than £30.
name[The Wrestlers], eatType[pub], food[Japanese], priceRange[£20-25], area[riverside], familyFriendly[yes], near[Raja Indian Cuisine]	The Wrestlers is a kid friendly Japanese pub in the riverside area near Raja Indian Cuisine with a price range of £20-25.
name[The Wrestlers], eatType[pub], food[Japanese], priceRange[cheap], area[riverside], familyFriendly[yes], near[Raja Indian Cuisine]	The Wrestlers is a cheap, family friendly Japanese pub in the riverside area near Raja Indian Cuisine.
name[The Wrestlers], eatType[pub], food[Japanese], priceRange[high], area[riverside], familyFriendly[yes], near[Raja Indian Cuisine]	The Wrestlers is a children friendly Japanese pub in the riverside area near Raja Indian Cuisine with a high price range.
name[The Wrestlers], eatType[pub], food[Japanese], priceRange[less than £20], area[city centre], familyFriendly[no], near[Raja Indian Cuisine]	The Wrestlers is a non family-friendly pub that serves Japanese food for less than £20. It is located in the city centre near Raja Indian Cuisine.
name[The Wrestlers], eatType[pub], food[Japanese], priceRange[less than £20], area[city centre], familyFriendly[yes], near[Raja Indian Cuisine]	The Wrestlers is a family-friendly Japanese pub in the city centre near Raja Indian Cuisine with a price range of less than £20.
name[The Wrestlers], eatType[pub], food[Japanese], priceRange[less than £20], area[riverside], familyFriendly[no], near[Raja Indian Cuisine]	The Wrestlers is a Japanese pub near Raja Indian Cuisine in the riverside area. It has a price range of less than £20 and is not family-friendly.
name[The Wrestlers], eatType[pub], food[Japanese], priceRange[less than £20], area[riverside], familyFriendly[yes], near[Raja Indian Cuisine]	The Wrestlers is a family friendly pub that serves Japanese food for less than £20. It is located in the riverside area near Raja Indian Cuisine.
name[The Wrestlers], eatType[pub], food[Japanese], priceRange[moderate], area[city centre], familyFriendly[no], near[Raja Indian Cuisine]	The Wrestlers is a moderately priced Japanese pub near Raja Indian Cuisine in the city centre. It is not kid friendly.
name[The Wrestlers], eatType[pub], food[Japanese], priceRange[moderate], area[city centre], familyFriendly[yes], near[Raja Indian Cuisine]	The Wrestlers is a moderately priced, kid friendly, Japanese pub near Raja Indian Cuisine in the city centre.
name[The Wrestlers], eatType[pub], food[Japanese], priceRange[moderate], area[riverside], familyFriendly[no], near[Raja Indian Cuisine]	The Wrestlers is a moderately priced Japanese pub in the riverside area near Raja Indian Cuisine. It is not kid friendly.
name[The Wrestlers], eatType[pub], food[Japanese], priceRange[moderate], area[riverside], familyFriendly[yes], near[Raja Indian Cuisine]	The Wrestlers is a pub providing Japanese food in the moderate price range. It is located in the riverside. It is near Raja Indian Cuisine.
name[The Wrestlers], eatType[pub], food[Japanese], priceRange[moderate], customer rating[1 out of 5], area[city centre], familyFriendly[yes], near[Raja Indian Cuisine]	The Wrestlers is a kid friendly Japanese pub in the city centre near Raja Indian Cuisine with a moderate price range and a customer rating of 1 out of 5.
name[The Wrestlers], eatType[pub], food[Japanese], priceRange[moderate], customer rating[1 out of 5], area[riverside], familyFriendly[no], near[Raja Indian Cuisine]	The Wrestlers is a moderately priced Japanese pub in the riverside area near Raja Indian Cuisine. It is not kid friendly and has a customer rating of 1 out of 5.
name[The Wrestlers], eatType[pub], food[Japanese], priceRange[moderate], customer rating[1 out of 5], area[riverside], familyFriendly[yes], near[Raja Indian Cuisine]	The Wrestlers is a moderately priced, kid friendly, Japanese pub in the riverside area near Raja Indian Cuisine with a customer rating of 1 out of 5.
name[The Wrestlers], eatType[pub], food[Japanese], priceRange[more than £30], area[city centre], familyFriendly[no], near[Raja Indian Cuisine]	The Wrestlers is a Japanese pub located in the city centre near Raja Indian Cuisine. It has a price range of more than £30 and is not children friendly.
name[The Wrestlers], eatType[pub], food[Japanese], priceRange[more than £30], area[city centre], familyFriendly[yes], near[Raja Indian Cuisine]	The Wrestlers is a children friendly Japanese pub in the city centre near Raja Indian Cuisine with a price range of more than £30.
name[The Wrestlers], eatType[pub], food[Japanese], priceRange[more than £30], area[riverside], familyFriendly[no], near[Raja Indian Cuisine]	The Wrestlers is a Japanese pub located in riverside near Raja Indian Cuisine. It is not children friendly and costs more than £30.
name[The Wrestlers], eatType[pub], food[Japanese], priceRange[more than £30], area[riverside], familyFriendly[yes], near[Raja Indian Cuisine]	The Wrestlers is a children friendly Japanese pub in riverside near Raja Indian Cuisine with a price range of more than £30.
name[The Wrestlers], eatType[pub], food[Japanese], priceRange[more than £30], customer rating[5 out of 5], area[city centre], familyFriendly[no], near[Raja Indian Cuisine]	The Wrestlers is a Japanese pub located in the city centre near Raja Indian Cuisine. It is not children friendly, has a price range of more than £30 and a customer rating of 5 out of 5.
name[The Wrestlers], eatType[pub], food[Japanese], priceRange[more than £30], customer rating[5 out of 5], area[city centre], familyFriendly[yes], near[Raja Indian Cuisine]	The Wrestlers is a children friendly Japanese pub in the city centre near Raja Indian Cuisine with a price range of more than £30 and a customer rating of 5 out of 5.
name[The Wrestlers], eatType[pub], food[Japanese], priceRange[more than £30], customer rating[5 out of 5], area[riverside], familyFriendly[no], near[Raja Indian Cuisine]	The Wrestlers is a Japanese pub located in riverside near Raja Indian Cuisine. It is not children friendly, has a price range of more than £30 and a customer rating of 5 out of 5.
name[The Wrestlers], eatType[pub], food[Japanese], priceRange[more than £30], customer rating[5 out of 5], area[riverside], familyFriendly[yes], near[Raja Indian Cuisine]	The Wrestlers is a high-priced, family-friendly pub located near Raja Indian Cuisine.
name[The Wrestlers], eatType[pub], food[Japanese], priceRange[more than £30], customer rating[low], area[city centre], familyFriendly[no], near[Raja Indian Cuisine]	The Wrestlers is a Japanese pub located in the city centre near Raja Indian Cuisine. It is not children friendly, has a low customer rating and a price range of more than £30.
name[The Wrestlers], eatType[pub], food[Japanese], priceRange[more than £30], customer rating[low], area[city centre], familyFriendly[yes], near[Raja Indian Cuisine]	The Wrestlers is a children friendly Japanese pub in the city centre near Raja Indian Cuisine with a low customer rating and a price range of more than £30.
name[The Wrestlers], eatType[pub], food[Japanese], priceRange[more than £30], customer rating[low], area[riverside], familyFriendly[no], near[Raja Indian Cuisine]	The Wrestlers is a Japanese pub near Raja Indian Cuisine in the riverside area. It is not children friendly and has a low customer rating. The price range is more than £30.
name[The Wrestlers], eatType[pub], food[Japanese], priceRange[more than £30], customer rating[low], area[riverside], familyFriendly[yes], near[Raja Indian Cuisine]	The Wrestlers is a children friendly Japanese pub near Raja Indian Cuisine in riverside with a low customer rating and a price range of more than £30.
name[The Wrestlers], eatType[restaurant], food[Italian], priceRange[less than £20], area[riverside], familyFriendly[no], near[Raja Indian Cuisine]	The Wrestlers is a restaurant providing Italian food in the less than £20 price range. It is located in the riverside. It is near Raja Indian Cuisine.
name[The Wrestlers], eatType[restaurant], food[Italian], priceRange[less than £20], area[riverside], familyFriendly[yes], near[Raja Indian Cuisine]	The Wrestlers is a family friendly restaurant located near Raja Indian Cuisine.
name[The Wrestlers], eatType[restaurant], food[Italian], priceRange[moderate], area[city centre], familyFriendly[no], near[Raja Indian Cuisine]	The Wrestlers is a moderately priced Italian restaurant in the city centre near Raja Indian Cuisine. It is not kid friendly.
name[The Wrestlers], eatType[restaurant], food[Italian], priceRange[moderate], area[city centre], familyFriendly[yes], near[Raja Indian Cuisine]	The Wrestlers is a moderately priced Italian restaurant in the city centre near Raja Indian Cuisine. It is kid friendly.
name[The Wrestlers], eatType[restaurant], food[Italian], priceRange[moderate], area[riverside], familyFriendly[no], near[Raja Indian Cuisine]	The Wrestlers is a moderately priced Italian restaurant in the riverside area near Raja Indian Cuisine. It is not kid friendly.
name[The Wrestlers], eatType[restaurant], food[Italian], priceRange[moderate], area[riverside], familyFriendly[yes], near[Raja Indian Cuisine]	The Wrestlers is a moderately priced Italian restaurant in the riverside area near Raja Indian Cuisine. It is kid friendly.
name[The Wrestlers], eatType[restaurant], food[Italian], priceRange[more than £30], area[riverside], familyFriendly[yes], near[Raja Indian Cuisine]	The Wrestlers is a children friendly Italian restaurant in the riverside area near Raja Indian Cuisine with a price range of more than £30.
name[The Wrestlers], eatType[restaurant], food[Japanese], priceRange[£20-25], area[riverside], familyFriendly[yes], near[Raja Indian Cuisine]	The Wrestlers is a kid friendly Japanese restaurant in the riverside area near Raja Indian Cuisine with a price range of £20-25.
name[The Wrestlers], eatType[restaurant], food[Japanese], priceRange[cheap], area[riverside], familyFriendly[yes], near[Raja Indian Cuisine]	The Wrestlers is a cheap, family friendly Japanese restaurant in the riverside area near Raja Indian Cuisine.
name[The Wrestlers], eatType[restaurant], food[Japanese], priceRange[high], area[riverside], familyFriendly[yes], near[Raja Indian Cuisine]	The Wrestlers is a children friendly Japanese restaurant in the riverside area near Raja Indian Cuisine with a high price range.
name[The Wrestlers], eatType[restaurant], food[Japanese], priceRange[less than £20], area[city centre], familyFriendly[no], near[Raja Indian Cuisine]	The Wrestlers is a Japanese restaurant located in the city centre near Raja Indian Cuisine. It has a price range of less than £20 and is not family-friendly.
name[The Wrestlers], eatType[restaurant], food[Japanese], priceRange[less than £20], area[city centre], familyFriendly[yes], near[Raja Indian Cuisine]	The Wrestlers is a family-friendly Japanese restaurant in the city centre near Raja Indian Cuisine with a price range less than £20.
name[The Wrestlers], eatType[restaurant], food[Japanese], priceRange[less than £20], area[riverside], familyFriendly[no], near[Raja Indian Cuisine]	The Wrestlers is a restaurant providing Japanese food in the less than £20 price range. It is located in the riverside. It is near Raja Indian Cuisine.
name[The Wrestlers], eatType[restaurant], food[Japanese], priceRange[less than £20], area[riverside], familyFriendly[yes], near[Raja Indian Cuisine]	The Wrestlers is a family friendly Japanese restaurant in the riverside area near Raja Indian Cuisine with a price range of less than £20.
name[The Wrestlers], eatType[restaurant], food[Japanese], priceRange[moderate], area[city centre], familyFriendly[no], near[Raja Indian Cuisine]	The Wrestlers is a moderately priced Japanese restaurant in the city centre near Raja Indian Cuisine. It is not kid friendly.
name[The Wrestlers], eatType[restaurant], food[Japanese], priceRange[moderate], area[city centre], familyFriendly[yes], near[Raja Indian Cuisine]	The Wrestlers is a moderately priced, kid friendly Japanese restaurant in the city centre near Raja Indian Cuisine.
name[The Wrestlers], eatType[restaurant], food[Japanese], priceRange[moderate], area[riverside], familyFriendly[no], near[Raja Indian Cuisine]	The Wrestlers is a moderately priced Japanese restaurant in riverside near Raja Indian Cuisine. It is not kid friendly.
name[The Wrestlers], eatType[restaurant], food[Japanese], priceRange[moderate], area[riverside], familyFriendly[yes], near[Raja Indian Cuisine]	The Wrestlers is a moderately priced, kid friendly Japanese restaurant in the riverside area near Raja Indian Cuisine.
name[The Wrestlers], eatType[restaurant], food[Japanese], priceRange[more than £30], area[city centre], familyFriendly[no], near[Raja Indian Cuisine]	The Wrestlers is a Japanese restaurant located in the city centre near Raja Indian Cuisine. It has a price range of more than £30 and is not children friendly.
name[The Wrestlers], eatType[restaurant], food[Japanese], priceRange[more than £30], area[city centre], familyFriendly[yes], near[Raja Indian Cuisine]	The Wrestlers is a children friendly Japanese restaurant in the city centre near Raja Indian Cuisine with a price range of more than £30.
name[The Wrestlers], eatType[restaurant], food[Japanese], priceRange[more than £30], area[riverside], familyFriendly[no], near[Raja Indian Cuisine]	The Wrestlers is a Japanese restaurant located in riverside near Raja Indian Cuisine. It is not children friendly and costs more than £30.
name[The Wrestlers], eatType[restaurant], food[Japanese], priceRange[more than £30], area[riverside], familyFriendly[yes], near[Raja Indian Cuisine]	The Wrestlers is a children friendly Japanese restaurant in riverside near Raja Indian Cuisine with a price range of more than £30.
name[Wildwood], eatType[coffee shop], area[riverside]	Wildwood is a coffee shop in the riverside area.
name[Wildwood], eatType[pub], area[riverside]	Wildwood is a pub in the riverside area.
name[Wildwood], eatType[pub], food[French], area[riverside], familyFriendly[yes], near[Raja Indian Cuisine]	Near Raja Indian Cuisine in the riverside area is a pub called Wildwood. It serves French food and is child friendly.
name[Wildwood], eatType[pub], food[Indian], area[city centre], familyFriendly[no], near[Raja Indian Cuisine]	Wildwood is a pub providing Indian food. It is located in the city centre. It is near Raja Indian Cuisine.
name[Wildwood], eatType[pub], food[Indian], area[city centre], familyFriendly[yes], near[Raja Indian Cuisine]	Near Raja Indian Cuisine in the city centre is a pub called Wildwood. It serves Indian food and is family friendly.
name[Wildwood], eatType[pub], food[Indian], area[riverside], familyFriendly[no], near[Raja Indian Cuisine]	Wildwood is a pub that provides Indian food. It is located in the riverside. It is near Raja Indian Cuisine.
name[Wildwood], eatType[pub], food[Indian], area[riverside], familyFriendly[yes], near[Raja Indian Cuisine]	Wildwood is a pub providing Indian food. It is located in the riverside. It is near Raja Indian Cuisine.
name[Wildwood], eatType[pub], food[Italian], area[city centre], familyFriendly[no], near[Raja Indian Cuisine]	Wildwood is an Italian pub near Raja Indian Cuisine in the city centre. It is not family-friendly.
name[Wildwood], eatType[pub], food[Italian], area[city centre], familyFriendly[yes], near[Raja Indian Cuisine]	There is a family-friendly Italian pub near Raja Indian Cuisine in the city centre called Wildwood.
name[Wildwood], eatType[pub], food[Italian], area[riverside], familyFriendly[no], near[Raja Indian Cuisine]	Wildwood is an Italian pub near Raja Indian Cuisine in the riverside area. It is not family-friendly.
name[Wildwood], eatType[pub], food[Italian], area[riverside], familyFriendly[yes], near[Raja Indian Cuisine]	Near Raja Indian Cuisine in the riverside area, there is a family friendly Italian pub called Wildwood.
name[Wildwood], eatType[restaurant], food[French], area[riverside], familyFriendly[yes], near[Raja Indian Cuisine]	Near Raja Indian Cuisine in the riverside area is a family friendly French restaurant called Wildwood.
name[Wildwood], eatType[restaurant], food[Indian], area[city centre], familyFriendly[no], near[Raja Indian Cuisine]	Wildwood is a restaurant providing Indian food. It is located in the city centre. It is near Raja Indian Cuisine.
name[Wildwood], eatType[restaurant], food[Indian], area[city centre], familyFriendly[yes], near[Raja Indian Cuisine]	There is a family friendly Indian restaurant in the city centre near Raja Indian Cuisine called Wildwood.
name[Wildwood], eatType[restaurant], food[Indian], area[riverside], familyFriendly[no], near[Raja Indian Cuisine]	Wildwood is a restaurant providing Indian food. It is located in the riverside. It is near Raja Indian Cuisine.
name[Wildwood], eatType[restaurant], food[Indian], area[riverside], familyFriendly[yes], near[Raja Indian Cuisine]	Near Raja Indian Cuisine in the riverside area is a family friendly Indian restaurant called Wildwood.
name[Wildwood], eatType[restaurant], food[Italian], area[city centre], familyFriendly[no], near[Raja Indian Cuisine]	Wildwood is an Italian restaurant near Raja Indian Cuisine in the city centre. It is not family-friendly.
name[Wildwood], eatType[restaurant], food[Italian], area[city centre], familyFriendly[yes], near[Raja Indian Cuisine]	Wildwood is a family-friendly Italian restaurant near Raja Indian Cuisine in the city centre.
name[Wildwood], eatType[restaurant], food[Italian], area[riverside], familyFriendly[no], near[Raja Indian Cuisine]	Wildwood is an Italian restaurant near Raja Indian Cuisine in the riverside area. It is not family-friendly.
name[Wildwood], eatType[restaurant], food[Italian], area[riverside], familyFriendly[yes], near[Raja Indian Cuisine]	Near Raja Indian Cuisine in the riverside area is a family friendly Italian restaurant called Wildwood.
name[Zizzi], eatType[coffee shop], area[riverside]	Zizzi is a coffee shop in the riverside area.
name[Zizzi], eatType[coffee shop], customer rating[average], near[Burger King]	Zizzi is a coffee shop near Burger King with an average customer rating.
name[Zizzi], eatType[coffee shop], customer rating[high], near[Burger King]	Zizzi is a highly rated coffee shop near Burger King.
name[Zizzi], eatType[coffee shop], near[The Sorrento]	A coffee shop near The Sorrento is Zizzi.
name[Zizzi], eatType[pub], area[riverside]	Zizzi is a pub in the riverside area.
name[Zizzi], eatType[pub], customer rating[average], near[Burger King]	Zizzi is an average rated pub near Burger King.
name[Zizzi], eatType[pub], customer rating[high], near[Burger King]	Zizzi is a pub near Burger King with a high customer rating.
name[Zizzi], eatType[pub], near[The Sorrento]	Zizzi is a pub near The Sorrento.