MR	output
"name[Blue Spice], eatType[coffee shop], area[city centre]"	"If you are looking for a coffee shop in the city centre, Blue Spice is a great place to go."
"name[Blue Spice], eatType[coffee shop], area[riverside]"	There is a coffee shop in the riverside area called Blue Spice which has a low customer rating.
"name[Blue Spice], eatType[coffee shop], customer rating[5 out of 5], near[Crowne Plaza Hotel]"	"With a customer rating of 5 out of 5, Blue Spice is a coffee shop near Crowne Plaza Hotel."
"name[Blue Spice], eatType[coffee shop], customer rating[average], near[Burger King]"	"Situated near Burger King, Blue Spice is a coffee shop with an average customer rating."
"name[Blue Spice], eatType[coffee shop], customer rating[average], near[Crowne Plaza Hotel]"	Customer rating is average and it is a coffee shop near Crowne Plaza Hotel called Blue Spice.
"name[Blue Spice], eatType[pub], area[city centre]"	In the city centre is a pub called Blue Spice.
"name[Blue Spice], eatType[pub], area[riverside]"	At the riverside there is a pub called Blue Spice.
"name[Blue Spice], eatType[pub], customer rating[5 out of 5], near[Crowne Plaza Hotel]"	"Situated near Crowne Plaza Hotel, Blue Spice is a pub with a customer rating of 5 out of 5."
"name[Blue Spice], eatType[pub], customer rating[average], near[Burger King]"	Customers rate Blue Spice as average. It is a pub near Burger King.
"name[Blue Spice], eatType[pub], customer rating[average], near[Crowne Plaza Hotel]"	The Blue Spice is a pub near Crowne Plaza Hotel with an average customer rating.
"name[Blue Spice], eatType[pub], food[Chinese], area[city centre], familyFriendly[no], near[Rainbow Vegetarian Café]"	Blue Spice is a pub that serves Chinese food in the city centre near Rainbow Vegetarian Café. It is not family-friendly.
"name[Blue Spice], eatType[pub], food[Chinese], area[city centre], familyFriendly[yes], near[Rainbow Vegetarian Café]"	"Serving Chinese food in a family-friendly pub setting, Blue Spice is located in the city centre near Rainbow Vegetarian Café."
"name[Blue Spice], eatType[pub], food[Chinese], area[riverside], familyFriendly[no], near[Rainbow Vegetarian Café]"	Near Rainbow Vegetarian Café in the riverside area is a pub called Blue Spice. It serves Chinese food and is not family-friendly.
"name[Blue Spice], eatType[pub], food[Chinese], area[riverside], familyFriendly[yes], near[Rainbow Vegetarian Café]"	By the riverside near Rainbow Vegetarian Café is a pub called Blue Spice. It serves Chinese food and is children friendly.
"name[Blue Spice], eatType[pub], food[English], area[city centre], familyFriendly[no], near[Rainbow Vegetarian Café]"	English food is served at Blue Spice pub located in the city centre near Rainbow Vegetarian Café. It is not family-friendly.
"name[Blue Spice], eatType[pub], food[English], area[city centre], familyFriendly[yes], near[Rainbow Vegetarian Café]"	Family friendly pub Blue Spice serves English food and is located near Rainbow Vegetarian Café in the city centre.
"name[Blue Spice], eatType[pub], food[English], area[riverside], familyFriendly[no], near[Rainbow Vegetarian Café]"	Riverside pub Blue Spice serves English food near Rainbow Vegetarian Café. It is not family-friendly.
"name[Blue Spice], eatType[pub], food[English], area[riverside], familyFriendly[yes], near[Rainbow Vegetarian Café]"	There is a pub called Blue Spice that serves English food and is kid friendly. It is located in the riverside area near Rainbow Vegetarian Café.
"name[Blue Spice], eatType[restaurant], food[Chinese], area[city centre], familyFriendly[no], near[Rainbow Vegetarian Café]"	A Chinese restaurant named Blue Spice is located in the city centre near Rainbow Vegetarian Café. It is not family-friendly.
"name[Blue Spice], eatType[restaurant], food[Chinese], area[city centre], familyFriendly[yes], near[Rainbow Vegetarian Café]"	Rainbow Vegetarian Café is a family-friendly restaurant called Blue Spice that serves Chinese food and is located in the city centre.
"name[Blue Spice], eatType[restaurant], food[Chinese], area[riverside], familyFriendly[no], near[Rainbow Vegetarian Café]"	"Situated in the riverside area near Rainbow Vegetarian Café, Blue Spice is a Chinese restaurant that is not family-friendly."
"name[Blue Spice], eatType[restaurant], food[Chinese], area[riverside], familyFriendly[yes], near[Rainbow Vegetarian Café]"	"If you are looking for a family friendly restaurant that serves Chinese food in the riverside area, try Blue Spice. It is located near Rainbow Vegetarian Café."
"name[Blue Spice], eatType[restaurant], food[English], area[city centre], familyFriendly[no], near[Rainbow Vegetarian Café]"	Blue Spice is a restaurant that serves English food in the city centre near Rainbow Vegetarian Café. It is not family-friendly.
"name[Blue Spice], eatType[restaurant], food[English], area[city centre], familyFriendly[yes], near[Rainbow Vegetarian Café]"	"For a family friendly English restaurant in the city centre near Rainbow Vegetarian Café, try Blue Spice."
"name[Blue Spice], eatType[restaurant], food[English], area[riverside], familyFriendly[no], near[Rainbow Vegetarian Café]"	"Situated in the riverside area near Rainbow Vegetarian Café, Blue Spice is a English restaurant that is not family-friendly."
"name[Blue Spice], eatType[restaurant], food[English], area[riverside], familyFriendly[yes], near[Rainbow Vegetarian Café]"	The Blue Spice is a restaurant that serves English food and is kid friendly. It is located in the riverside area near Rainbow Vegetarian Café.
"name[Clowns], eatType[coffee shop], customer rating[3 out of 5], near[All Bar One]"	Close to All Bar One is a 3 out of 5 rated coffee shop called Clowns.
"name[Clowns], eatType[coffee shop], customer rating[5 out of 5], near[Crowne Plaza Hotel]"	The Clowns is a coffee shop near Crowne Plaza Hotel with a customer rating of 5 out of 5.
"name[Clowns], eatType[coffee shop], near[The Sorrento]"	The Clowns is a coffee shop near The Sorrento with an average customer rating.
"name[Clowns], eatType[pub], customer rating[3 out of 5], near[All Bar One]"	"If you are looking for a pub near All Bar One, try Clowns. It has a customer rating of 3 out of 5."
"name[Clowns], eatType[pub], customer rating[5 out of 5], near[Crowne Plaza Hotel]"	Customers have rated Clowns 5 out of 5. It is a pub near Crowne Plaza Hotel.
"name[Clowns], eatType[pub], near[The Sorrento]"	Next to The Sorrento is a pub called Clowns.
"name[Cocum], eatType[coffee shop], customer rating[high], near[Burger King]"	Check out Cocum coffee shop near Burger King. It has a high customer rating.
"name[Cocum], eatType[coffee shop], customer rating[high], near[Café Sicilia]"	Next to Café Sicilia is a coffee shop called Cocum. It has a high customer rating.
"name[Cocum], eatType[coffee shop], customer rating[low], near[Café Sicilia]"	"If you are looking for a coffee shop with a low customer rating, try Cocum. It is located near Café Sicilia."
"name[Cocum], eatType[coffee shop], customer rating[low], near[Express by Holiday Inn]"	The Cocum is a coffee shop near Express by Holiday Inn with a low customer rating.
"name[Cocum], eatType[coffee shop], near[The Rice Boat]"	There is a coffee shop near The Rice Boat called Cocum. It is rated average by customers.
"name[Cocum], eatType[coffee shop], near[The Sorrento]"	"If you are looking for a coffee shop near The Sorrento, try Cocum. It has a customer rating of 3 out of 5."
"name[Cocum], eatType[pub], customer rating[high], near[Burger King]"	A pub near Burger King is Cocum. It has a high customer rating.
"name[Cocum], eatType[pub], customer rating[high], near[Café Sicilia]"	Come to Cocum pub near Café Sicilia.  It has a high customer rating.
"name[Cocum], eatType[pub], customer rating[low], near[Café Sicilia]"	Close to Café Sicilia is Cocum pub. It has a low customer rating.
"name[Cocum], eatType[pub], customer rating[low], near[Express by Holiday Inn]"	The Cocum is a pub near Express by Holiday Inn with a low customer rating.
"name[Cocum], eatType[pub], near[The Rice Boat]"	"For a pub near The Rice Boat, try Cocum."
"name[Cocum], eatType[pub], near[The Sorrento]"	"For a pub near The Sorrento, try Cocum."
"name[Cotto], eatType[coffee shop], near[The Bakers]"	There is a coffee shop near The Bakers called Cotto that has a customer rating of 5 out of 5.
"name[Cotto], eatType[pub], near[The Bakers]"	Close to The Bakers is Cotto pub.
"name[Giraffe], eatType[coffee shop], near[The Bakers]"	"Situated near The Bakers, Giraffe is a coffee shop with a price range of £20-25."
"name[Giraffe], eatType[coffee shop], near[The Rice Boat]"	There is a coffee shop near The Rice Boat called Giraffe that has a customer rating of 5 out of 5.
"name[Giraffe], eatType[pub], food[English], area[riverside], familyFriendly[yes], near[Rainbow Vegetarian Café]"	Riverside pub Giraffe is a child friendly English restaurant near Rainbow Vegetarian Café.
"name[Giraffe], eatType[pub], food[Fast food], area[city centre], familyFriendly[no], near[Rainbow Vegetarian Café]"	Rainbow Vegetarian Café is not a family-friendly pub called Giraffe that serves Fast food and is located in the city centre.
"name[Giraffe], eatType[pub], food[Fast food], area[city centre], familyFriendly[yes], near[Rainbow Vegetarian Café]"	"Located in the city centre near Rainbow Vegetarian Café, Giraffe is a family-friendly pub serving Fast food."
"name[Giraffe], eatType[pub], food[Fast food], area[riverside], familyFriendly[no], near[Rainbow Vegetarian Café]"	Near Rainbow Vegetarian Café in the riverside area is a pub called Giraffe. It serves Fast food and is not family-friendly.
"name[Giraffe], eatType[pub], food[Fast food], area[riverside], familyFriendly[yes], near[Rainbow Vegetarian Café]"	Near Rainbow Vegetarian Café in the riverside area is a pub called Giraffe. It serves Fast food and is children friendly.
"name[Giraffe], eatType[pub], food[Fast food], area[riverside], familyFriendly[yes], near[Raja Indian Cuisine]"	At the riverside near Raja Indian Cuisine is a child friendly pub called Giraffe that serves Fast food.
"name[Giraffe], eatType[pub], food[French], area[city centre], familyFriendly[no], near[Raja Indian Cuisine]"	There is a pub called Giraffe that serves French food in the city centre near Raja Indian Cuisine. It is not family-friendly.
"name[Giraffe], eatType[pub], food[French], area[city centre], familyFriendly[yes], near[Raja Indian Cuisine]"	"For a family-friendly pub serving French food in the city centre, Giraffe is located near Raja Indian Cuisine."
"name[Giraffe], eatType[pub], food[French], area[riverside], familyFriendly[no], near[Raja Indian Cuisine]"	"Located near Raja Indian Cuisine in the riverside area, Giraffe is a pub that serves French food. It is not family-friendly."
"name[Giraffe], eatType[pub], food[French], area[riverside], familyFriendly[yes], near[Raja Indian Cuisine]"	Family friendly pub Giraffe serves French food and is located near Raja Indian Cuisine in the riverside area.
"name[Giraffe], eatType[pub], near[The Bakers]"	The Bakers is a pub called Giraffe which is located near The Bakers.
"name[Giraffe], eatType[pub], near[The Rice Boat]"	"For a pub near The Rice Boat, try Giraffe."
"name[Giraffe], eatType[restaurant], food[English], area[riverside], familyFriendly[yes], near[Rainbow Vegetarian Café]"	The Giraffe is a restaurant that serves English food and is kid friendly. It is located in the riverside area near Rainbow Vegetarian Café.
"name[Giraffe], eatType[restaurant], food[Fast food], area[city centre], familyFriendly[no], near[Rainbow Vegetarian Café]"	Giraffe is a restaurant that serves Fast food in the city centre near Rainbow Vegetarian Café. It is not family-friendly.
"name[Giraffe], eatType[restaurant], food[Fast food], area[city centre], familyFriendly[yes], near[Rainbow Vegetarian Café]"	There is a family-friendly restaurant called Giraffe that serves Fast food and is located in the city centre near Rainbow Vegetarian Café.
"name[Giraffe], eatType[restaurant], food[Fast food], area[riverside], familyFriendly[no], near[Rainbow Vegetarian Café]"	"Serving Fast food, Giraffe is a restaurant in the riverside area near Rainbow Vegetarian Café. It is not family-friendly."
"name[Giraffe], eatType[restaurant], food[Fast food], area[riverside], familyFriendly[yes], near[Rainbow Vegetarian Café]"	The Giraffe is a restaurant that serves Fast food and is kid friendly. It is located in the riverside area near Rainbow Vegetarian Café.
"name[Giraffe], eatType[restaurant], food[Fast food], area[riverside], familyFriendly[yes], near[Raja Indian Cuisine]"	The Giraffe is a restaurant that serves Fast food and is kid friendly. It is located in the riverside area near Raja Indian Cuisine.
"name[Giraffe], eatType[restaurant], food[French], area[city centre], familyFriendly[no], near[Raja Indian Cuisine]"	Giraffe is a restaurant that serves French food in the city centre near Raja Indian Cuisine. It is not family-friendly.
"name[Giraffe], eatType[restaurant], food[French], area[city centre], familyFriendly[yes], near[Raja Indian Cuisine]"	"For a family friendly French restaurant in the city centre near Raja Indian Cuisine, try Giraffe."
"name[Giraffe], eatType[restaurant], food[French], area[riverside], familyFriendly[no], near[Raja Indian Cuisine]"	The Giraffe is a restaurant that serves French food near the Raja Indian Cuisine in the riverside area. It is not family-friendly.
"name[Giraffe], eatType[restaurant], food[French], area[riverside], familyFriendly[yes], near[Raja Indian Cuisine]"	"If you are looking for a family friendly restaurant that serves French food in the riverside area, try Giraffe. It is located near Raja Indian Cuisine."
"name[Green Man], eatType[coffee shop], customer rating[1 out of 5], near[All Bar One]"	"If you are looking for a coffee shop with a customer rating of 1 out of 5, try Green Man. It is located near All Bar One."
"name[Green Man], eatType[coffee shop], customer rating[3 out of 5], near[All Bar One]"	Close to All Bar One is a 3 out of 5 rated coffee shop called Green Man.
"name[Green Man], eatType[pub], customer rating[1 out of 5], near[All Bar One]"	Close to All Bar One is a pub called Green Man. It has a customer rating of 1 out of 5.
"name[Green Man], eatType[pub], customer rating[3 out of 5], near[All Bar One]"	Close to All Bar One is a pub called Green Man. It has a customer rating of 3 out of 5.
"name[Green Man], eatType[pub], food[Italian], area[riverside], familyFriendly[yes], near[Express by Holiday Inn]"	At the riverside near Express by Holiday Inn is a child friendly pub called Green Man that serves Italian food.
"name[Green Man], eatType[pub], food[Italian], area[riverside], familyFriendly[yes], near[Raja Indian Cuisine]"	There is a pub called Green Man that serves Italian food and is kid friendly. It is located in the riverside area near Raja Indian Cuisine.
"name[Green Man], eatType[pub], food[Japanese], area[city centre], familyFriendly[no], near[Express by Holiday Inn]"	Green Man is a pub that serves Japanese food in the city centre near Express by Holiday Inn. It is not family-friendly.
"name[Green Man], eatType[pub], food[Japanese], area[city centre], familyFriendly[yes], near[Express by Holiday Inn]"	"For a family-friendly pub serving Japanese food in the city centre, Green Man is located near Express by Holiday Inn."
"name[Green Man], eatType[pub], food[Japanese], area[riverside], familyFriendly[no], near[Express by Holiday Inn]"	At the riverside near Express by Holiday Inn is a pub called Green Man. It serves Japanese food and is not family-friendly.
"name[Green Man], eatType[pub], food[Japanese], area[riverside], familyFriendly[yes], near[Express by Holiday Inn]"	Family friendly pub Green Man serves Japanese food and is located near Express by Holiday Inn in the riverside area.
"name[Green Man], eatType[restaurant], food[Italian], area[riverside], familyFriendly[yes], near[Express by Holiday Inn]"	Children friendly Italian restaurant Green Man is located in riverside near Express by Holiday Inn.
"name[Green Man], eatType[restaurant], food[Italian], area[riverside], familyFriendly[yes], near[Raja Indian Cuisine]"	The Green Man is a restaurant that serves Italian food and is kid friendly. It is located in the riverside area near Raja Indian Cuisine.
"name[Green Man], eatType[restaurant], food[Japanese], area[city centre], familyFriendly[no], near[Express by Holiday Inn]"	A Japanese restaurant named Green Man is located in the city centre near Express by Holiday Inn. It is not family-friendly.
"name[Green Man], eatType[restaurant], food[Japanese], area[city centre], familyFriendly[yes], near[Express by Holiday Inn]"	"If you are looking for a family-friendly restaurant that serves Japanese food in the city centre, try Green Man. It is located near Express by Holiday Inn."
"name[Green Man], eatType[restaurant], food[Japanese], area[riverside], familyFriendly[no], near[Express by Holiday Inn]"	On the riverside near Express by Holiday Inn is a Japanese restaurant called Green Man. It is not family-friendly.
"name[Green Man], eatType[restaurant], food[Japanese], area[riverside], familyFriendly[yes], near[Express by Holiday Inn]"	Riverside restaurant Green Man is a child friendly Japanese restaurant near Express by Holiday Inn.
"name[Loch Fyne], eatType[coffee shop], area[riverside]"	At the riverside there is a coffee shop called Loch Fyne with a customer rating of 3 out of 5.
"name[Loch Fyne], eatType[pub], area[riverside]"	"If you are looking for a pub in the riverside area, try Loch Fyne."
"name[Strada], eatType[coffee shop], area[city centre]"	"If you are looking for a coffee shop in the city centre, Strada is a great place to go."
"name[Strada], eatType[coffee shop], customer rating[1 out of 5], near[All Bar One]"	The Strada is a coffee shop near All Bar One with a customer rating of 1 out of 5.
"name[Strada], eatType[coffee shop], customer rating[1 out of 5], near[Rainbow Vegetarian Café]"	Close to Rainbow Vegetarian Café is a coffee shop called Strada. It has a customer rating of 1 out of 5.
"name[Strada], eatType[coffee shop], customer rating[low], near[Express by Holiday Inn]"	Check out Strada coffee shop near Express by Holiday Inn. It has a low customer rating.
"name[Strada], eatType[pub], area[city centre]"	"If you are looking for a pub in the city centre, try Strada."
"name[Strada], eatType[pub], customer rating[1 out of 5], near[All Bar One]"	Come visit Strada pub near All Bar One. It has a customer rating of 1 out of 5.
"name[Strada], eatType[pub], customer rating[1 out of 5], near[Rainbow Vegetarian Café]"	Although Strada is a pub near Rainbow Vegetarian Café with a customer rating of 1 out of 5.
"name[Strada], eatType[pub], customer rating[low], near[Express by Holiday Inn]"	"With a low customer rating, Strada is a pub near Express by Holiday Inn."
"name[The Cricketers], eatType[coffee shop], customer rating[1 out of 5], familyFriendly[yes], near[Avalon]"	Next to Avalon is a coffee shop called The Cricketers. It is kid friendly and has a customer rating of 1 out of 5.
"name[The Cricketers], eatType[coffee shop], customer rating[3 out of 5], familyFriendly[yes], near[Avalon]"	The Cricketers is a coffee shop near Avalon. It is kid friendly and has a customer rating of 3 out of 5.
"name[The Cricketers], eatType[coffee shop], customer rating[3 out of 5], familyFriendly[yes], near[Crowne Plaza Hotel]"	The Cricketers is a coffee shop near Crowne Plaza Hotel. It is kid friendly and has a customer rating of 3 out of 5.
"name[The Cricketers], eatType[coffee shop], customer rating[5 out of 5], familyFriendly[no], near[Crowne Plaza Hotel]"	The Cricketers is a coffee shop near Crowne Plaza Hotel. It is not family-friendly and has a customer rating of 5 out of 5.
"name[The Cricketers], eatType[coffee shop], customer rating[5 out of 5], familyFriendly[yes], near[Crowne Plaza Hotel]"	Family friendly coffee shop The Cricketers is located near Crowne Plaza Hotel and has a customer rating of 5 out of 5.
"name[The Cricketers], eatType[coffee shop], customer rating[average], familyFriendly[no], near[Café Sicilia]"	Coffee shop The Cricketers is not family-friendly and has an average customer rating. It is located near Café Sicilia.
"name[The Cricketers], eatType[coffee shop], customer rating[average], familyFriendly[no], near[Crowne Plaza Hotel]"	"Although not family-friendly, The Cricketers coffee shop is near Crowne Plaza Hotel and has an average customer rating."
"name[The Cricketers], eatType[coffee shop], customer rating[average], familyFriendly[yes], near[Café Sicilia]"	Coffee shop The Cricketers is family friendly and has an average customer rating. It is located near Café Sicilia.
"name[The Cricketers], eatType[coffee shop], customer rating[high], familyFriendly[yes], near[Café Sicilia]"	Children friendly coffee shop near Café Sicilia is The Cricketers. It has a high customer rating.
"name[The Cricketers], eatType[coffee shop], customer rating[high], familyFriendly[yes], near[Express by Holiday Inn]"	Close to Express by Holiday Inn is a child friendly coffee shop called The Cricketers. It has a high customer rating.
"name[The Cricketers], eatType[coffee shop], customer rating[low], familyFriendly[no], near[Express by Holiday Inn]"	Next to Express by Holiday Inn is a coffee shop called The Cricketers. It is not family friendly and has a low customer rating.
"name[The Cricketers], eatType[coffee shop], customer rating[low], familyFriendly[no], near[Ranch]"	"Although not family-friendly, The Cricketers coffee shop is near Ranch and has a low customer rating."
"name[The Cricketers], eatType[coffee shop], customer rating[low], familyFriendly[yes], near[Ranch]"	The Cricketers is a coffee shop near Ranch. It is children friendly and has a low customer rating.
"name[The Cricketers], eatType[restaurant], customer rating[1 out of 5], familyFriendly[yes], near[Avalon]"	Come to The Cricketers restaurant near Avalon. It is kid friendly and has a customer rating of 1 out of 5.
"name[The Cricketers], eatType[restaurant], customer rating[3 out of 5], familyFriendly[yes], near[Avalon]"	Close to Avalon is a kid friendly restaurant called The Cricketers. It has a customer rating of 3 out of 5.
"name[The Cricketers], eatType[restaurant], customer rating[3 out of 5], familyFriendly[yes], near[Crowne Plaza Hotel]"	Come to The Cricketers restaurant near Crowne Plaza Hotel. It is kid friendly and has a customer rating of 3 out of 5.
"name[The Cricketers], eatType[restaurant], customer rating[5 out of 5], familyFriendly[no], near[Crowne Plaza Hotel]"	The Cricketers restaurant is not family-friendly and has a customer rating of 5 out of 5.  It is located near Crowne Plaza Hotel.
"name[The Cricketers], eatType[restaurant], customer rating[5 out of 5], familyFriendly[yes], near[Crowne Plaza Hotel]"	Family friendly restaurant The Cricketers is located near Crowne Plaza Hotel and has a customer rating of 5 out of 5.
"name[The Cricketers], eatType[restaurant], customer rating[average], familyFriendly[no], near[Café Sicilia]"	Close to Café Sicilia is a restaurant called The Cricketers. It has an average customer rating and is not family-friendly.
"name[The Cricketers], eatType[restaurant], customer rating[average], familyFriendly[no], near[Crowne Plaza Hotel]"	Close to Crowne Plaza Hotel is a restaurant called The Cricketers. It has an average customer rating and is not family-friendly.
"name[The Cricketers], eatType[restaurant], customer rating[average], familyFriendly[yes], near[Café Sicilia]"	Children friendly restaurant The Cricketers has an average customer rating. It is located near Café Sicilia.
"name[The Cricketers], eatType[restaurant], customer rating[high], familyFriendly[yes], near[Café Sicilia]"	"If you are looking for a highly rated restaurant that is kid friendly, try The Cricketers. It is located near Café Sicilia."
"name[The Cricketers], eatType[restaurant], customer rating[high], familyFriendly[yes], near[Express by Holiday Inn]"	Come to The Cricketers restaurant near Express by Holiday Inn. It is kid friendly and has a high customer rating.
"name[The Cricketers], eatType[restaurant], customer rating[low], familyFriendly[no], near[Express by Holiday Inn]"	The Cricketers is a restaurant near Express by Holiday Inn with a low customer rating. It is not family-friendly.
"name[The Cricketers], eatType[restaurant], customer rating[low], familyFriendly[no], near[Ranch]"	Near Ranch is a restaurant called The Cricketers. It is not family-friendly and has a low customer rating.
"name[The Cricketers], eatType[restaurant], customer rating[low], familyFriendly[yes], near[Ranch]"	The Cricketers restaurant is located near Ranch. It is family friendly and has a low customer rating.
"name[The Cricketers], eatType[restaurant], food[Chinese], priceRange[£20-25], customer rating[high], area[city centre], familyFriendly[no], near[All Bar One]"	Coffee shop The Cricketers is a Chinese restaurant with a high customer rating and a price range of £20-25. It is located in the city centre and is not kid friendly.
"name[The Cricketers], eatType[restaurant], food[Chinese], priceRange[£20-25], customer rating[high], area[city centre], familyFriendly[yes], near[All Bar One]"	High rated Chinese restaurant The Cricketers is located in the city centre near All Bar One. It is kids friendly and has a price range of £20-25.
"name[The Cricketers], eatType[restaurant], food[Chinese], priceRange[£20-25], customer rating[high], area[riverside], familyFriendly[no], near[All Bar One]"	All Bar One is a restaurant named The Cricketers that serves Chinese food and has a high customer rating. It is not kid friendly and is in the riverside area.
"name[The Cricketers], eatType[restaurant], food[Chinese], priceRange[£20-25], customer rating[high], area[riverside], familyFriendly[yes], near[All Bar One]"	"Located in the riverside area near All Bar One, The Cricketers is a kid friendly restaurant with a price range of £20-25."
"name[The Cricketers], eatType[restaurant], food[Chinese], priceRange[cheap], customer rating[5 out of 5], area[city centre], familyFriendly[no], near[All Bar One]"	This restaurant is located in the city centre near the All Bar One and is called The Cricketers. It serves Chinese food and is cheap. It has a customer rating of 5 out of 5.
"name[The Cricketers], eatType[restaurant], food[Chinese], priceRange[cheap], customer rating[5 out of 5], area[city centre], familyFriendly[yes], near[All Bar One]"	The Cricketers is a cheap Chinese restaurant in the city centre near All Bar One. It is family-friendly and has a customer rating of 5 out of 5.
"name[The Cricketers], eatType[restaurant], food[Chinese], priceRange[cheap], customer rating[5 out of 5], area[riverside], familyFriendly[no], near[All Bar One]"	The Cricketers is a restaurant that serves Chinese food and is located near All Bar One in the riverside area. It is not family-friendly and has a customer rating of 5 out of 5.
"name[The Cricketers], eatType[restaurant], food[Chinese], priceRange[cheap], customer rating[5 out of 5], area[riverside], familyFriendly[yes], near[All Bar One]"	At the riverside there is a cheap restaurant called The Cricketers that is family friendly and serves Chinese food. It is located near All Bar One.
"name[The Cricketers], eatType[restaurant], food[Chinese], priceRange[cheap], customer rating[average], area[city centre], familyFriendly[no], near[All Bar One]"	The Cricketers is a restaurant that serves Chinese food and is located in the city centre near All Bar One. It has an average customer rating and is cheap.
"name[The Cricketers], eatType[restaurant], food[Chinese], priceRange[cheap], customer rating[average], area[city centre], familyFriendly[yes], near[All Bar One]"	This restaurant is called The Cricketers and is family-friendly. It is located in the city centre area and has an average customer rating. It is located near All Bar One and has a cheap price range.
"name[The Cricketers], eatType[restaurant], food[Chinese], priceRange[cheap], customer rating[average], area[riverside], familyFriendly[no], near[All Bar One]"	Coffee shop The Cricketers is a restaurant that serves Chinese food and is not family-friendly. It has an average customer rating and is cheap. It is located in the riverside area.
"name[The Cricketers], eatType[restaurant], food[Chinese], priceRange[cheap], customer rating[average], area[riverside], familyFriendly[yes], near[All Bar One]"	There is a cheap restaurant The Cricketers located in the riverside area near All Bar One. It is family friendly and has an average customer rating.
"name[The Cricketers], eatType[restaurant], food[Chinese], priceRange[high], customer rating[1 out of 5], area[city centre], familyFriendly[no], near[All Bar One]"	High priced Chinese restaurant The Cricketers is located in the city centre near All Bar One. It is not children friendly and has a customer rating of 1 out of 5.
"name[The Cricketers], eatType[restaurant], food[Chinese], priceRange[high], customer rating[1 out of 5], area[city centre], familyFriendly[yes], near[All Bar One]"	The Cricketers is a children friendly restaurant with a high price range and a customer rating of 1 out of 5. It is located in the city centre near All Bar One.
"name[The Cricketers], eatType[restaurant], food[Chinese], priceRange[high], customer rating[1 out of 5], area[riverside], familyFriendly[no], near[All Bar One]"	Although The Cricketers is a high priced restaurant in the riverside area that is not child friendly and has a customer rating of 1 out of 5.
"name[The Cricketers], eatType[restaurant], food[Chinese], priceRange[high], customer rating[1 out of 5], area[riverside], familyFriendly[yes], near[All Bar One]"	There is a high priced restaurant The Cricketers located in the riverside area near All Bar One. It is children friendly and has a customer rating of 1 out of 5.
"name[The Cricketers], eatType[restaurant], food[Chinese], priceRange[high], customer rating[average], area[city centre], familyFriendly[no], near[All Bar One]"	The Cricketers is a restaurant that serves Chinese food and is located in the city centre near All Bar One. It is not children friendly and has a high price range.
"name[The Cricketers], eatType[restaurant], food[Chinese], priceRange[high], customer rating[average], area[city centre], familyFriendly[yes], near[All Bar One]"	A Chinese restaurant named The Cricketers is located in the city centre near All Bar One. It is children friendly and has a high price range.
"name[The Cricketers], eatType[restaurant], food[Chinese], priceRange[high], customer rating[average], area[riverside], familyFriendly[no], near[All Bar One]"	A Chinese restaurant named The Cricketers is located in the riverside area near All Bar One. It has a high price range and is not children friendly.
"name[The Cricketers], eatType[restaurant], food[Chinese], priceRange[high], customer rating[average], area[riverside], familyFriendly[yes], near[All Bar One]"	The Cricketers is a children friendly restaurant in the riverside area near All Bar One with an average customer rating and a high price range.
"name[The Cricketers], eatType[restaurant], food[Chinese], priceRange[less than £20], customer rating[low], area[city centre], familyFriendly[no], near[All Bar One]"	"This restaurant is not family-friendly, but it is called The Cricketers and is located in the city centre near All Bar One. It has a price range of less than £20 and is rated low."
"name[The Cricketers], eatType[restaurant], food[Chinese], priceRange[less than £20], customer rating[low], area[city centre], familyFriendly[yes], near[All Bar One]"	There is a family-friendly restaurant named The Cricketers in the city centre near All Bar One with a low customer rating and a price range of less than £20.
"name[The Cricketers], eatType[restaurant], food[Chinese], priceRange[less than £20], customer rating[low], area[riverside], familyFriendly[no], near[All Bar One]"	"Situated in the riverside area near All Bar One, The Cricketers is a restaurant that serves Chinese food for less than £20."
"name[The Cricketers], eatType[restaurant], food[Chinese], priceRange[less than £20], customer rating[low], area[riverside], familyFriendly[yes], near[All Bar One]"	Located near All Bar One is a family friendly restaurant called The Cricketers. It has a low customer rating and a price range of less than £20.
"name[The Cricketers], eatType[restaurant], food[Chinese], priceRange[moderate], customer rating[1 out of 5], area[city centre], familyFriendly[no], near[All Bar One]"	Near All Bar One is a moderately priced restaurant called The Cricketers. It is not kid friendly and has a customer rating of 1 out of 5.
"name[The Cricketers], eatType[restaurant], food[Chinese], priceRange[moderate], customer rating[1 out of 5], area[city centre], familyFriendly[yes], near[All Bar One]"	Located in the city centre near All Bar One is a kid friendly restaurant called The Cricketers. It has a customer rating of 1 out of 5.
"name[The Cricketers], eatType[restaurant], food[Chinese], priceRange[moderate], customer rating[1 out of 5], area[riverside], familyFriendly[no], near[All Bar One]"	On the riverside near All Bar One is a moderately priced restaurant called The Cricketers. It is not kids friendly.
"name[The Cricketers], eatType[restaurant], food[Chinese], priceRange[moderate], customer rating[1 out of 5], area[riverside], familyFriendly[yes], near[All Bar One]"	There is a moderately priced restaurant The Cricketers located in the riverside area near All Bar One. It is kids friendly and has a customer rating of 1 out of 5.
"name[The Cricketers], eatType[restaurant], food[Chinese], priceRange[moderate], customer rating[3 out of 5], area[city centre], familyFriendly[no], near[All Bar One]"	Chinese restaurant The Cricketers is located in the city centre near All Bar One. It is not kid friendly and has a customer rating of 3 out of 5.
"name[The Cricketers], eatType[restaurant], food[Chinese], priceRange[moderate], customer rating[3 out of 5], area[city centre], familyFriendly[yes], near[All Bar One]"	This restaurant is called The Cricketers and is located in the city centre near All Bar One. It is kids friendly and has a customer rating of 3 out of 5. It serves Chinese food.
"name[The Cricketers], eatType[restaurant], food[Chinese], priceRange[moderate], customer rating[3 out of 5], area[riverside], familyFriendly[no], near[All Bar One]"	In the riverside area near All Bar One is a moderately priced restaurant called The Cricketers. It is not kid friendly.
"name[The Cricketers], eatType[restaurant], food[Chinese], priceRange[moderate], customer rating[3 out of 5], area[riverside], familyFriendly[yes], near[All Bar One]"	Riverside restaurant The Cricketers is a kid friendly restaurant with a moderate price range and a customer rating of 3 out of 5. It is located near All Bar One.
"name[The Cricketers], eatType[restaurant], food[Chinese], priceRange[more than £30], customer rating[high], area[city centre], familyFriendly[no], near[All Bar One]"	High rated Chinese restaurant The Cricketers is located in the city centre near All Bar One. It is not children friendly.
"name[The Cricketers], eatType[restaurant], food[Chinese], priceRange[more than £30], customer rating[high], area[city centre], familyFriendly[yes], near[All Bar One]"	There is a children friendly restaurant named The Cricketers with a high customer rating in the city centre near All Bar One with a price range of more than £30.
"name[The Cricketers], eatType[restaurant], food[Chinese], priceRange[more than £30], customer rating[high], area[riverside], familyFriendly[no], near[All Bar One]"	The Cricketers is a high rated restaurant in the riverside area near All Bar One. It is not children friendly and the price range is more than £30.
"name[The Cricketers], eatType[restaurant], food[Chinese], priceRange[more than £30], customer rating[high], area[riverside], familyFriendly[yes], near[All Bar One]"	Children friendly The Cricketers restaurant is located in the riverside area near All Bar One. It has a high customer rating and a price range of more than £30.
"name[The Cricketers], eatType[restaurant], food[English], priceRange[£20-25], customer rating[high], area[city centre], familyFriendly[no], near[All Bar One]"	Near All Bar One is a restaurant called The Cricketers which serves English food and has a high customer rating. It is not kid friendly and has a price range of £20-25.
"name[The Cricketers], eatType[restaurant], food[English], priceRange[£20-25], customer rating[high], area[city centre], familyFriendly[yes], near[All Bar One]"	This restaurant is located in the city centre near the All Bar One.  It is called The Cricketers and is kid friendly.  It has a high customer rating and a price range of £20-25.
"name[The Cricketers], eatType[restaurant], food[English], priceRange[£20-25], customer rating[high], area[riverside], familyFriendly[no], near[All Bar One]"	Coffee shop The Cricketers is a restaurant providing English food in the £20-25 price range. It is located in the riverside. It is near All Bar One. Its customer rating is high.
"name[The Cricketers], eatType[restaurant], food[English], priceRange[£20-25], customer rating[high], area[riverside], familyFriendly[yes], near[All Bar One]"	The Cricketers is a restaurant providing English food in the £20-25 price range. It is located in the riverside. It is near All Bar One.
"name[The Cricketers], eatType[restaurant], food[English], priceRange[cheap], customer rating[5 out of 5], area[city centre], familyFriendly[no], near[Café Rouge]"	An English restaurant named The Cricketers is located in the city centre near Café Rouge. It is not family-friendly and has a customer rating of 5 out of 5.
"name[The Cricketers], eatType[restaurant], food[English], priceRange[cheap], customer rating[5 out of 5], area[city centre], familyFriendly[yes], near[Café Rouge]"	A cheap English restaurant in the city centre is The Cricketers. It is family-friendly and has a customer rating of 5 out of 5.
"name[The Cricketers], eatType[restaurant], food[English], priceRange[cheap], customer rating[5 out of 5], area[riverside], familyFriendly[no], near[Café Rouge]"	The Cricketers is a cheap English restaurant located in riverside near Café Rouge. It is not family-friendly and has a customer rating of 5 out of 5.
"name[The Cricketers], eatType[restaurant], food[English], priceRange[cheap], customer rating[5 out of 5], area[riverside], familyFriendly[yes], near[Café Rouge]"	At the riverside there is a cheap restaurant called The Cricketers that is family friendly and serves English food. It is located near Café Rouge.
"name[The Cricketers], eatType[restaurant], food[English], priceRange[cheap], customer rating[average], area[city centre], familyFriendly[no], near[Café Rouge]"	The Cricketers is a restaurant that serves English food and is located in the city centre near Café Rouge. It has an average customer rating and is not family-friendly.
"name[The Cricketers], eatType[restaurant], food[English], priceRange[cheap], customer rating[average], area[city centre], familyFriendly[yes], near[Café Rouge]"	This restaurant is called The Cricketers and is family-friendly. It is located in the city centre area and has an average customer rating. It is located near Café Rouge and has a cheap price range.
"name[The Cricketers], eatType[restaurant], food[English], priceRange[cheap], customer rating[average], area[riverside], familyFriendly[no], near[Café Rouge]"	"Located in the riverside area near Café Rouge, The Cricketers is a restaurant that serves English food. It is not family-friendly and has an average customer rating."
"name[The Cricketers], eatType[restaurant], food[English], priceRange[cheap], customer rating[average], area[riverside], familyFriendly[yes], near[Café Rouge]"	The Cricketers is a restaurant that serves English food and is family friendly. It is located in the riverside area near Café Rouge.
"name[The Cricketers], eatType[restaurant], food[English], priceRange[high], customer rating[1 out of 5], area[city centre], familyFriendly[no], near[Café Rouge]"	High priced English restaurant The Cricketers is located in the city centre near Café Rouge. It is not children friendly and has a customer rating of 1 out of 5.
"name[The Cricketers], eatType[restaurant], food[English], priceRange[high], customer rating[1 out of 5], area[city centre], familyFriendly[yes], near[Café Rouge]"	There is a children friendly restaurant named The Cricketers with a high price range and a customer rating of 1 out of 5. It is located in the city centre near Café Rouge.
"name[The Cricketers], eatType[restaurant], food[English], priceRange[high], customer rating[1 out of 5], area[riverside], familyFriendly[no], near[Café Rouge]"	There is a high priced restaurant The Cricketers located in the riverside area near Café Rouge. It is not children friendly and has a customer rating of 1 out of 5.
"name[The Cricketers], eatType[restaurant], food[English], priceRange[high], customer rating[1 out of 5], area[riverside], familyFriendly[yes], near[Café Rouge]"	Riverside has a children friendly restaurant named The Cricketers with a high price range and a customer rating of 1 out of 5. It is located near Café Rouge.
"name[The Cricketers], eatType[restaurant], food[English], priceRange[high], customer rating[average], area[city centre], familyFriendly[no], near[Café Rouge]"	The Cricketers is a high priced restaurant in the city centre that serves English food. It is not children friendly and is located near Café Rouge.
"name[The Cricketers], eatType[restaurant], food[English], priceRange[high], customer rating[average], area[city centre], familyFriendly[yes], near[Café Rouge]"	The Cricketers is a children friendly restaurant with an average customer rating in the high price range and is located in the city centre near Café Rouge.
"name[The Cricketers], eatType[restaurant], food[English], priceRange[high], customer rating[average], area[riverside], familyFriendly[no], near[Café Rouge]"	There is a high priced restaurant The Cricketers located in the riverside area near Café Rouge. It is not children friendly and has an average customer rating.
"name[The Mill], eatType[pub], food[English], priceRange[high], area[riverside], familyFriendly[yes], near[Raja Indian Cuisine]"	Riverside has a children friendly pub near Raja Indian Cuisine called The Mill which serves English food and has a high price range.
"name[The Mill], eatType[pub], food[English], priceRange[less than £20], area[city centre], familyFriendly[no], near[Raja Indian Cuisine]"	The Mill is a pub that serves English food for less than £20. It is located in the city centre near Raja Indian Cuisine and is not family-friendly.
"name[The Mill], eatType[pub], food[English], priceRange[less than £20], area[city centre], familyFriendly[yes], near[Raja Indian Cuisine]"	The Mill is a pub that serves English food for less than £20. It is family-friendly and located in the city centre near Raja Indian Cuisine.
"name[The Mill], eatType[pub], food[English], priceRange[less than £20], area[riverside], familyFriendly[no], near[Raja Indian Cuisine]"	Serving English food in the riverside area is a pub called The Mill. It is not family-friendly and is located near Raja Indian Cuisine. It has a price range of less than £20.
"name[The Mill], eatType[pub], food[English], priceRange[less than £20], area[riverside], familyFriendly[yes], near[Raja Indian Cuisine]"	In the riverside area near Raja Indian Cuisine is a family friendly pub called The Mill which serves English food for less than £20.
"name[The Mill], eatType[pub], food[English], priceRange[moderate], area[city centre], familyFriendly[no], near[Raja Indian Cuisine]"	A pub named The Mill is located in the city centre near Raja Indian Cuisine. It serves English food and is moderately priced. It is not kid friendly.
"name[The Mill], eatType[pub], food[English], priceRange[moderate], area[city centre], familyFriendly[yes], near[Raja Indian Cuisine]"	"For a moderate priced English pub near Raja Indian Cuisine in the city centre, try The Mill. It is kid friendly."
"name[The Mill], eatType[pub], food[English], priceRange[moderate], area[riverside], familyFriendly[no], near[Raja Indian Cuisine]"	Serving English food in the riverside area is a moderately priced pub named The Mill. It is not kid friendly and is located near Raja Indian Cuisine.
"name[The Mill], eatType[pub], food[English], priceRange[moderate], area[riverside], familyFriendly[yes], near[Raja Indian Cuisine]"	In the riverside area near Raja Indian Cuisine is a kid friendly pub called The Mill which serves English food at a moderate price.
"name[The Mill], eatType[pub], food[English], priceRange[more than £30], area[riverside], familyFriendly[yes], near[Raja Indian Cuisine]"	"Located near Raja Indian Cuisine in the riverside area, The Mill is a children friendly pub that serves English food and has a price range of more than £30."
"name[The Mill], eatType[pub], food[Fast food], priceRange[£20-25], area[riverside], familyFriendly[yes], near[Raja Indian Cuisine]"	Near Raja Indian Cuisine in the riverside area is a kid friendly pub called The Mill which serves Fast food and has a price range of £20-25.
"name[The Mill], eatType[pub], food[Fast food], priceRange[£20-25], customer rating[high], area[city centre], familyFriendly[no], near[Café Rouge]"	There is a pub called The Mill that serves Fast food in the £20-25 price range with a high customer rating in the city centre near Café Rouge and is not kid friendly.
"name[The Mill], eatType[pub], food[Fast food], priceRange[£20-25], customer rating[high], area[city centre], familyFriendly[yes], near[Café Rouge]"	The Mill is a pub that serves Fast food in the £20-25 price range. It is located in the city centre near Café Rouge. It is kid friendly and has a high customer rating.
"name[The Mill], eatType[pub], food[Fast food], priceRange[£20-25], customer rating[high], area[riverside], familyFriendly[no], near[Café Rouge]"	Near Café Rouge in the riverside area is a pub called The Mill. It serves Fast food and has a high customer rating. It is not kid friendly and has a price range of £20-25.
"name[The Mill], eatType[pub], food[Fast food], priceRange[£20-25], customer rating[high], area[riverside], familyFriendly[yes], near[Café Rouge]"	This pub is located near Café Rouge in the riverside area.  It is called The Mill and is kid friendly.  It serves Fast food and has a high customer rating.  Prices range from £20-25.
"name[The Mill], eatType[pub], food[Fast food], priceRange[£20-25], customer rating[high], area[riverside], familyFriendly[yes], near[Café Sicilia]"	This pub is located near Café Sicilia in the riverside area.  It is called The Mill and is kid friendly.  It serves Fast food and has a high customer rating.  Prices range from £20-25.
"name[The Mill], eatType[pub], food[Fast food], priceRange[cheap], area[riverside], familyFriendly[yes], near[Raja Indian Cuisine]"	The Mill is a cheap family friendly pub serving Fast food in the riverside area near Raja Indian Cuisine.
"name[The Mill], eatType[pub], food[Fast food], priceRange[cheap], customer rating[5 out of 5], area[city centre], familyFriendly[no], near[Café Sicilia]"	The Mill is a cheap pub that serves Fast food. It is located in the city centre near Café Sicilia. It is not family-friendly and has a customer rating of 5 out of 5.
"name[The Mill], eatType[pub], food[Fast food], priceRange[cheap], customer rating[5 out of 5], area[city centre], familyFriendly[yes], near[Café Sicilia]"	Cheap Fast food is served at The Mill pub in the city centre near Café Sicilia. It is family-friendly and has a customer rating of 5 out of 5.
"name[The Mill], eatType[pub], food[Fast food], priceRange[cheap], customer rating[5 out of 5], area[riverside], familyFriendly[no], near[Café Sicilia]"	This pub is located in the riverside area near Café Sicilia and is called The Mill. It serves Fast food and has a customer rating of 5 out of 5. It is cheap and not family-friendly.
"name[The Mill], eatType[pub], food[Fast food], priceRange[cheap], customer rating[5 out of 5], area[riverside], familyFriendly[yes], near[Café Sicilia]"	Cheap Fast food is served at The Mill pub in the riverside area near Café Sicilia. It is family friendly and has a customer rating of 5 out of 5.
"name[The Mill], eatType[pub], food[Fast food], priceRange[cheap], customer rating[average], area[city centre], familyFriendly[no], near[Café Sicilia]"	The Mill is a cheap pub that serves Fast food. It is located in the city centre near Café Sicilia. It has an average customer rating and is not family-friendly.
"name[The Mill], eatType[pub], food[Fast food], priceRange[cheap], customer rating[average], area[city centre], familyFriendly[yes], near[Café Sicilia]"	A cheap Fast food pub near Café Sicilia in the city centre is The Mill. It is family-friendly and has an average customer rating.
"name[The Mill], eatType[pub], food[Fast food], priceRange[cheap], customer rating[average], area[riverside], familyFriendly[no], near[Café Sicilia]"	On the riverside near Café Sicilia is a pub called The Mill. It serves Fast food and has an average customer rating. It is not family-friendly.
"name[The Mill], eatType[pub], food[Fast food], priceRange[cheap], customer rating[average], area[riverside], familyFriendly[yes], near[Café Sicilia]"	Cheap Fast food is served at The Mill pub in the riverside area near Café Sicilia. It is family friendly and has an average customer rating.
"name[The Mill], eatType[pub], food[Fast food], priceRange[high], customer rating[1 out of 5], area[city centre], familyFriendly[no], near[Café Sicilia]"	The Mill is a pub that serves Fast food in the high price range and is located in the city centre near Café Sicilia. It is not children friendly and has a customer rating of 1 out of 5.
"name[The Mill], eatType[pub], food[Fast food], priceRange[high], customer rating[1 out of 5], area[city centre], familyFriendly[yes], near[Café Sicilia]"	High priced Fast food pub The Mill is located in the city centre near Café Sicilia. It is children friendly and has a customer rating of 1 out of 5.
"name[The Mill], eatType[pub], food[Fast food], priceRange[high], customer rating[1 out of 5], area[riverside], familyFriendly[no], near[Café Sicilia]"	On the riverside near Café Sicilia is a pub called The Mill. It serves Fast food and is not children friendly. It has a high price range and a customer rating of 1 out of 5.
"name[The Mill], eatType[pub], food[Fast food], priceRange[high], customer rating[1 out of 5], area[riverside], familyFriendly[yes], near[Café Sicilia]"	The Mill is a pub that serves Fast food and is children friendly. It is in the high price range and has a customer rating of 1 out of 5. It is located in the riverside area near Café Sicilia.
"name[The Mill], eatType[pub], food[Fast food], priceRange[high], customer rating[average], area[city centre], familyFriendly[no], near[Café Sicilia]"	The Mill is a pub that serves Fast food in the high price range with an average customer rating in the city centre near Café Sicilia. It is not children friendly.
"name[The Mill], eatType[pub], food[Fast food], priceRange[high], customer rating[average], area[city centre], familyFriendly[yes], near[Café Sicilia]"	"Situated in the city centre near Café Sicilia, The Mill is a high priced pub that serves Fast food. It is children friendly and has an average customer rating."
"name[The Mill], eatType[pub], food[Fast food], priceRange[high], customer rating[average], area[riverside], familyFriendly[no], near[Café Sicilia]"	On the riverside near Café Sicilia is a pub called The Mill. It serves Fast food and is not children friendly. It has a high price range and an average customer rating.
"name[The Mill], eatType[pub], food[Fast food], priceRange[high], customer rating[average], area[riverside], familyFriendly[yes], near[Café Sicilia]"	The Mill is a pub that serves Fast food and is children friendly. It is in the high price range and has an average customer rating. It is located in the riverside area near Café Sicilia.
"name[The Mill], eatType[pub], food[Fast food], priceRange[less than £20], customer rating[low], area[city centre], familyFriendly[no], near[Café Sicilia]"	The Mill is a pub that serves Fast food for less than £20. It is located in the city centre near Café Sicilia. It is not family-friendly and has a low customer rating.
"name[The Mill], eatType[pub], food[Fast food], priceRange[less than £20], customer rating[low], area[city centre], familyFriendly[yes], near[Café Sicilia]"	"Although it has a low customer rating, The Mill is a family-friendly pub serving Fast food for less than £20. It is located in the city centre near Café Sicilia."
"name[The Mill], eatType[pub], food[Fast food], priceRange[less than £20], customer rating[low], area[riverside], familyFriendly[no], near[Café Sicilia]"	In the riverside area near Café Sicilia is a pub called The Mill. It serves Fast food and has a low customer rating. It is not family-friendly and has a price range of less than £20.
"name[The Mill], eatType[pub], food[Fast food], priceRange[less than £20], customer rating[low], area[riverside], familyFriendly[yes], near[Café Sicilia]"	"Although it has a low customer rating, The Mill is a family friendly pub serving Fast food in the riverside area near Café Sicilia."
"name[The Mill], eatType[pub], food[Fast food], priceRange[moderate], customer rating[1 out of 5], area[city centre], familyFriendly[no], near[Café Sicilia]"	A Fast food pub named The Mill is located in the city centre near Café Sicilia. It has a moderate price range and a customer rating of 1 out of 5. It is not kid friendly.
"name[The Mill], eatType[pub], food[Fast food], priceRange[moderate], customer rating[1 out of 5], area[city centre], familyFriendly[yes], near[Café Sicilia]"	Moderately priced Fast food pub The Mill is located in the city centre near Café Sicilia. It is kid friendly and has a customer rating of 1 out of 5.
"name[The Mill], eatType[pub], food[Fast food], priceRange[moderate], customer rating[1 out of 5], area[riverside], familyFriendly[no], near[Café Sicilia]"	Café Sicilia is a pub called The Mill that serves Fast food and is not kid friendly. It has a moderate price range and a customer rating of 1 out of 5. It is located in the riverside area.
"name[The Mill], eatType[pub], food[Fast food], priceRange[moderate], customer rating[1 out of 5], area[riverside], familyFriendly[yes], near[Café Sicilia]"	The Mill is a pub that serves Fast food and is kid friendly. It is located in the riverside area near Café Sicilia. It has a moderate price range and a customer rating of 1 out of 5.
"name[The Mill], eatType[pub], food[Fast food], priceRange[moderate], customer rating[3 out of 5], area[city centre], familyFriendly[no], near[Café Sicilia]"	A Fast food pub named The Mill is located in the city centre near Café Sicilia. It has a moderate price range and a customer rating of 3 out of 5. It is not kid friendly.
"name[The Mill], eatType[pub], food[Fast food], priceRange[moderate], customer rating[3 out of 5], area[city centre], familyFriendly[yes], near[Café Sicilia]"	The Mill is a moderately priced pub that serves Fast food. It is located in the city centre near Café Sicilia. It is kid friendly and has a customer rating of 3 out of 5.
"name[The Mill], eatType[pub], food[Fast food], priceRange[moderate], customer rating[3 out of 5], area[riverside], familyFriendly[no], near[Café Sicilia]"	Moderately priced Fast food pub The Mill is located in riverside near Café Sicilia. It is not kid friendly and has a customer rating of 3 out of 5.
"name[The Mill], eatType[pub], food[Fast food], priceRange[moderate], customer rating[3 out of 5], area[riverside], familyFriendly[yes], near[Café Sicilia]"	The Mill is a moderately priced pub that serves Fast food. It is located in the riverside area near Café Sicilia. It is kid friendly and has a customer rating of 3 out of 5.
"name[The Mill], eatType[restaurant], food[English], priceRange[high], area[riverside], familyFriendly[yes], near[Raja Indian Cuisine]"	If you are looking for a children friendly restaurant in the riverside area then try The Mill. It is near Raja Indian Cuisine and is in the high price range.
"name[The Mill], eatType[restaurant], food[English], priceRange[high], customer rating[average], area[riverside], familyFriendly[yes], near[Café Rouge]"	"Located in the riverside area near Café Rouge, The Mill is a children friendly restaurant with a high price range."
"name[The Mill], eatType[restaurant], food[English], priceRange[less than £20], area[city centre], familyFriendly[no], near[Raja Indian Cuisine]"	English restaurant The Mill is located in the city centre near Raja Indian Cuisine. It is not family-friendly and is in the less than £20 price range.
"name[The Mill], eatType[restaurant], food[English], priceRange[less than £20], area[city centre], familyFriendly[yes], near[Raja Indian Cuisine]"	The Mill is a family-friendly restaurant that serves English food for less than £20. It is located in the city centre near Raja Indian Cuisine.
"name[The Mill], eatType[restaurant], food[English], priceRange[less than £20], area[riverside], familyFriendly[no], near[Raja Indian Cuisine]"	The Mill is a restaurant providing English food in the less than £20 price range. It is located in the riverside. It is near Raja Indian Cuisine.
"name[The Mill], eatType[restaurant], food[English], priceRange[less than £20], area[riverside], familyFriendly[yes], near[Raja Indian Cuisine]"	The Mill is a family friendly restaurant that serves English food for less than £20. It is located in the riverside area near Raja Indian Cuisine.
"name[The Mill], eatType[restaurant], food[English], priceRange[less than £20], customer rating[low], area[city centre], familyFriendly[no], near[Café Rouge]"	An English restaurant named The Mill is located in the city centre near Café Rouge. It is not family-friendly and has a price range of less than £20.
"name[The Mill], eatType[restaurant], food[English], priceRange[less than £20], customer rating[low], area[city centre], familyFriendly[yes], near[Café Rouge]"	A family-friendly restaurant named The Mill is located in the city centre near Café Rouge. It has a low customer rating and a price range of less than £20.
"name[The Mill], eatType[restaurant], food[English], priceRange[less than £20], customer rating[low], area[riverside], familyFriendly[no], near[Café Rouge]"	There is a cheap restaurant The Mill located near Café Rouge that provides English food. It is not family-friendly and has a low customer rating.
"name[The Mill], eatType[restaurant], food[English], priceRange[less than £20], customer rating[low], area[riverside], familyFriendly[yes], near[Café Rouge]"	Next to Café Rouge is a family friendly restaurant called The Mill. It has a low customer rating and a price range of less than £20.
"name[The Mill], eatType[restaurant], food[English], priceRange[moderate], area[city centre], familyFriendly[no], near[Raja Indian Cuisine]"	A English restaurant named The Mill is located in the city centre near Raja Indian Cuisine. It is not kid friendly and is moderately priced.
"name[The Mill], eatType[restaurant], food[English], priceRange[moderate], area[city centre], familyFriendly[yes], near[Raja Indian Cuisine]"	Moderately priced English restaurant The Mill is located in the city centre near Raja Indian Cuisine. It is kid friendly.
"name[The Mill], eatType[restaurant], food[English], priceRange[moderate], area[riverside], familyFriendly[no], near[Raja Indian Cuisine]"	In the riverside area near Raja Indian Cuisine is a moderately priced restaurant called The Mill. It is not kid friendly.
"name[The Mill], eatType[restaurant], food[English], priceRange[moderate], area[riverside], familyFriendly[yes], near[Raja Indian Cuisine]"	The Mill is a moderately priced restaurant that serves English food and is kid friendly. It is located in the riverside area near Raja Indian Cuisine.
"name[The Mill], eatType[restaurant], food[English], priceRange[moderate], customer rating[1 out of 5], area[city centre], familyFriendly[no], near[Café Rouge]"	There is a moderately priced restaurant The Mill located in the city centre that provides English food Its customer rating is 1 out of 5. It is not kids friendly.
"name[The Mill], eatType[restaurant], food[English], priceRange[moderate], customer rating[1 out of 5], area[city centre], familyFriendly[yes], near[Café Rouge]"	There is a moderate priced restaurant The Mill located in the city centre near Café Rouge that is kid friendly and has a customer rating of 1 out of 5.
"name[The Mill], eatType[restaurant], food[English], priceRange[moderate], customer rating[1 out of 5], area[riverside], familyFriendly[no], near[Café Rouge]"	There is a moderately priced restaurant The Mill located in the riverside area near Café Rouge. It is not kids friendly and has a customer rating of 1 out of 5.
"name[The Mill], eatType[restaurant], food[English], priceRange[moderate], customer rating[1 out of 5], area[riverside], familyFriendly[yes], near[Café Rouge]"	The Mill is a restaurant providing English food in the moderate price range. It is located in the riverside. It is near Café Rouge.
"name[The Mill], eatType[restaurant], food[English], priceRange[moderate], customer rating[3 out of 5], area[city centre], familyFriendly[no], near[Café Rouge]"	English restaurant The Mill is located in the city centre near Café Rouge. It is not kid friendly and has a customer rating of 3 out of 5.
"name[The Mill], eatType[restaurant], food[English], priceRange[moderate], customer rating[3 out of 5], area[city centre], familyFriendly[yes], near[Café Rouge]"	There is a moderate priced restaurant The Mill located in the city centre near Café Rouge. It is kid friendly and has a customer rating of 3 out of 5.
"name[The Mill], eatType[restaurant], food[English], priceRange[moderate], customer rating[3 out of 5], area[riverside], familyFriendly[no], near[Café Rouge]"	"Located in the riverside area near Café Rouge, The Mill is a restaurant that serves English food. It is not kid friendly."
"name[The Mill], eatType[restaurant], food[English], priceRange[moderate], customer rating[3 out of 5], area[riverside], familyFriendly[yes], near[Café Rouge]"	On the riverside near Café Rouge is a kid friendly restaurant called The Mill. It has a customer rating of 3 out of 5.
"name[The Mill], eatType[restaurant], food[English], priceRange[more than £30], area[riverside], familyFriendly[yes], near[Raja Indian Cuisine]"	By the riverside and near Raja Indian Cuisine is a child friendly restaurant called The Mill. It serves English food.
"name[The Mill], eatType[restaurant], food[English], priceRange[more than £30], customer rating[high], area[city centre], familyFriendly[no], near[Café Rouge]"	Café Rouge is a high rated English restaurant called The Mill with a price range of more than £30 and is not children friendly.
"name[The Mill], eatType[restaurant], food[English], priceRange[more than £30], customer rating[high], area[city centre], familyFriendly[yes], near[Café Rouge]"	Located in the city centre near Café Rouge is a high rated restaurant called The Mill. It is children friendly and has a price range of more than £30.
"name[The Mill], eatType[restaurant], food[English], priceRange[more than £30], customer rating[high], area[riverside], familyFriendly[no], near[Café Rouge]"	The Mill is a high rated restaurant in the riverside area near Café Rouge. It is not children friendly and the price range is more than £30.
"name[The Mill], eatType[restaurant], food[English], priceRange[more than £30], customer rating[high], area[riverside], familyFriendly[yes], near[Café Rouge]"	The Mill is a children friendly restaurant with a high customer rating and a price range of more than £30. It is located in the riverside area near Café Rouge.
"name[The Mill], eatType[restaurant], food[Fast food], priceRange[£20-25], area[riverside], familyFriendly[yes], near[Raja Indian Cuisine]"	"Situated in the riverside area near Raja Indian Cuisine, The Mill is a kid friendly restaurant with a price range of £20-25."
"name[The Mill], eatType[restaurant], food[Fast food], priceRange[cheap], area[riverside], familyFriendly[yes], near[Raja Indian Cuisine]"	Cheap Fast food in a family friendly restaurant called The Mill in the riverside area.
"name[The Phoenix], eatType[pub], food[Fast food], priceRange[cheap], area[riverside], familyFriendly[yes], near[Raja Indian Cuisine]"	Children friendly pub The Phoenix serves cheap Fast food near Raja Indian Cuisine in the riverside area.
"name[The Phoenix], eatType[pub], food[Fast food], priceRange[high], area[city centre], familyFriendly[no], near[Raja Indian Cuisine]"	Fast food pub The Phoenix is located in the city centre near Raja Indian Cuisine. It is not children friendly and has a high price range.
"name[The Phoenix], eatType[pub], food[Fast food], priceRange[high], area[city centre], familyFriendly[yes], near[Raja Indian Cuisine]"	The Phoenix is a pub that serves Fast food in the high price range and is children friendly. It is located in the city centre near Raja Indian Cuisine.
"name[The Phoenix], eatType[pub], food[Fast food], priceRange[high], area[riverside], familyFriendly[no], near[Raja Indian Cuisine]"	The Phoenix is a pub that serves Fast food at a high price range. It is located in the riverside area near Raja Indian Cuisine. It is not children friendly.
"name[The Phoenix], eatType[pub], food[Fast food], priceRange[high], area[riverside], familyFriendly[yes], near[Raja Indian Cuisine]"	The Phoenix is a pub that serves Fast food and is located near Raja Indian Cuisine in the riverside area. It is children friendly and has a high price range.
"name[The Phoenix], eatType[pub], food[Fast food], priceRange[less than £20], area[city centre], familyFriendly[no], near[Raja Indian Cuisine]"	The Phoenix is a pub that serves Fast food for less than £20. It is located in the city centre near Raja Indian Cuisine and is not family-friendly.
"name[The Phoenix], eatType[pub], food[Fast food], priceRange[less than £20], area[city centre], familyFriendly[yes], near[Raja Indian Cuisine]"	The Phoenix is a pub that serves Fast food for less than £20. It is family-friendly and located in the city centre near Raja Indian Cuisine.
"name[The Phoenix], eatType[pub], food[Fast food], priceRange[less than £20], area[riverside], familyFriendly[no], near[Raja Indian Cuisine]"	The Phoenix is a pub that serves Fast food for less than £20. It is not family-friendly and is located near Raja Indian Cuisine in the riverside area.
"name[The Phoenix], eatType[pub], food[Fast food], priceRange[less than £20], area[riverside], familyFriendly[yes], near[Raja Indian Cuisine]"	The Phoenix is a family friendly pub that serves Fast food for less than £20. It is located in the riverside area near Raja Indian Cuisine.
"name[The Phoenix], eatType[pub], food[Fast food], priceRange[moderate], area[city centre], familyFriendly[no], near[Raja Indian Cuisine]"	A pub named The Phoenix is located in the city centre near Raja Indian Cuisine. It serves Fast food and is moderately priced. It is not kid friendly.
"name[The Phoenix], eatType[pub], food[Fast food], priceRange[moderate], area[city centre], familyFriendly[yes], near[Raja Indian Cuisine]"	"For a moderate priced Fast food pub near Raja Indian Cuisine in the city centre, try The Phoenix. It is kid friendly."
"name[The Phoenix], eatType[pub], food[Fast food], priceRange[moderate], area[riverside], familyFriendly[no], near[Raja Indian Cuisine]"	"Located near Raja Indian Cuisine in the riverside area, The Phoenix is a moderately priced pub serving Fast food. It is not kid friendly."
"name[The Phoenix], eatType[pub], food[Fast food], priceRange[moderate], area[riverside], familyFriendly[yes], near[Raja Indian Cuisine]"	On the riverside near Raja Indian Cuisine is a kids friendly pub called The Phoenix which serves Fast food at a moderate price.
"name[The Phoenix], eatType[pub], food[Fast food], priceRange[moderate], customer rating[3 out of 5], area[riverside], familyFriendly[yes], near[Café Sicilia]"	The Phoenix is a pub that serves Fast food and is kid friendly. It is located in the riverside area near Café Sicilia. It has a moderate price range and a customer rating of 3 out of 5.
"name[The Phoenix], eatType[pub], food[Fast food], priceRange[more than £30], area[riverside], familyFriendly[yes], near[Raja Indian Cuisine]"	"Located near Raja Indian Cuisine in the riverside area, The Phoenix is a children friendly pub that serves Fast food and has a price range of more than £30."
"name[The Phoenix], eatType[pub], food[Fast food], priceRange[more than £30], customer rating[high], area[city centre], familyFriendly[no], near[Café Sicilia]"	This pub is not children friendly and has a high customer rating.  It is called The Phoenix and is near Café Sicilia in the city centre.  It serves Fast food and has a price range of more than £30.
"name[The Phoenix], eatType[pub], food[Fast food], priceRange[more than £30], customer rating[high], area[city centre], familyFriendly[yes], near[Café Sicilia]"	Child friendly The Phoenix is a pub that serves Fast food and is located in the city centre near Café Sicilia. It has a high customer rating and a price range of more than £30.
"name[The Phoenix], eatType[pub], food[Fast food], priceRange[more than £30], customer rating[high], area[riverside], familyFriendly[no], near[Café Sicilia]"	In the riverside area near Café Sicilia is a pub called The Phoenix. It serves Fast food and has a high customer rating. It is not children friendly and has a price range of more than £30.
"name[The Phoenix], eatType[pub], food[Fast food], priceRange[more than £30], customer rating[high], area[riverside], familyFriendly[yes], near[Café Sicilia]"	The Phoenix is a children friendly pub with a high customer rating and a price range of more than £30. It is located in the riverside area near Café Sicilia.
"name[The Phoenix], eatType[pub], food[French], priceRange[£20-25], area[riverside], familyFriendly[yes], near[Raja Indian Cuisine]"	Riverside has a pub named The Phoenix that serves French food and is kids friendly. It is near Raja Indian Cuisine and has a price range of £20-25.
"name[The Phoenix], eatType[pub], food[French], priceRange[£20-25], customer rating[3 out of 5], area[city centre], familyFriendly[no], near[Café Sicilia]"	The Phoenix is a pub that serves French food in the £20-25 price range with a customer rating of 3 out of 5. It is located in the city centre near Café Sicilia and is not kid friendly.
"name[The Phoenix], eatType[pub], food[French], priceRange[£20-25], customer rating[3 out of 5], area[city centre], familyFriendly[yes], near[Café Sicilia]"	The Phoenix is a pub that serves French food in the £20-25 price range. It is located in the city centre near Café Sicilia. It is kid friendly and has a customer rating of 3 out of 5.
"name[The Phoenix], eatType[pub], food[French], priceRange[£20-25], customer rating[3 out of 5], area[riverside], familyFriendly[no], near[Café Sicilia]"	At the riverside near Café Sicilia is a pub called The Phoenix. It serves French food and has a customer rating of 3 out of 5. It is not kid friendly and has a price range of £20-25.
"name[The Phoenix], eatType[pub], food[French], priceRange[£20-25], customer rating[3 out of 5], area[riverside], familyFriendly[yes], near[Café Sicilia]"	At the riverside near Café Sicilia is a pub called The Phoenix. It serves French food and has a customer rating of 3 out of 5. It is kids friendly.
"name[The Phoenix], eatType[pub], food[French], priceRange[£20-25], customer rating[3 out of 5], area[riverside], familyFriendly[yes], near[Crowne Plaza Hotel]"	On the riverside near Crowne Plaza Hotel is a pub called The Phoenix. It is kids friendly and has a customer rating of 3 out of 5. It has a price range of £20-25.
"name[The Phoenix], eatType[pub], food[French], priceRange[£20-25], customer rating[high], area[city centre], familyFriendly[no], near[Crowne Plaza Hotel]"	There is a pub called The Phoenix that serves French food in the £20-25 price range with a high customer rating in the city centre near Crowne Plaza Hotel and is not kid friendly.
"name[The Phoenix], eatType[pub], food[French], priceRange[£20-25], customer rating[high], area[city centre], familyFriendly[yes], near[Crowne Plaza Hotel]"	High rated French pub The Phoenix is kids friendly and in the city centre near Crowne Plaza Hotel. It has a price range of £20-25.
"name[The Phoenix], eatType[pub], food[French], priceRange[£20-25], customer rating[high], area[riverside], familyFriendly[no], near[Crowne Plaza Hotel]"	Crowne Plaza Hotel is a pub called The Phoenix that serves French food and has a high customer rating. It is not kid friendly and is in the riverside area. It has a price range of £20-25.
"name[The Phoenix], eatType[pub], food[French], priceRange[£20-25], customer rating[high], area[riverside], familyFriendly[yes], near[Crowne Plaza Hotel]"	This pub is located near Crowne Plaza Hotel in the riverside area.  It is called The Phoenix and is kid friendly.  It serves French food and has a high customer rating.  Prices range from £20-25.
"name[The Phoenix], eatType[pub], food[French], priceRange[cheap], area[riverside], familyFriendly[yes], near[Raja Indian Cuisine]"	"If you're looking for a cheap family friendly pub in the riverside area, try The Phoenix. It serves French food and is located near Raja Indian Cuisine."
"name[The Phoenix], eatType[pub], food[French], priceRange[cheap], customer rating[5 out of 5], area[city centre], familyFriendly[no], near[Crowne Plaza Hotel]"	The Phoenix is a cheap pub that serves French food. It is located in the city centre near Crowne Plaza Hotel. It is not family-friendly and has a customer rating of 5 out of 5.
"name[The Phoenix], eatType[pub], food[French], priceRange[cheap], customer rating[5 out of 5], area[city centre], familyFriendly[yes], near[Crowne Plaza Hotel]"	Cheap French food is served at The Phoenix pub in the city centre near Crowne Plaza Hotel. It is family-friendly and has a customer rating of 5 out of 5.
"name[The Phoenix], eatType[pub], food[French], priceRange[cheap], customer rating[5 out of 5], area[riverside], familyFriendly[no], near[Crowne Plaza Hotel]"	This pub is located in the riverside area near Crowne Plaza Hotel and is called The Phoenix. It serves French food and has a customer rating of 5 out of 5. It is cheap and not family-friendly.
"name[The Phoenix], eatType[pub], food[French], priceRange[cheap], customer rating[5 out of 5], area[riverside], familyFriendly[yes], near[Crowne Plaza Hotel]"	Cheap French food is served at The Phoenix pub in the riverside area near Crowne Plaza Hotel. It is family friendly and has a customer rating of 5 out of 5.
"name[The Phoenix], eatType[pub], food[French], priceRange[high], area[riverside], familyFriendly[yes], near[Raja Indian Cuisine]"	Family friendly pub The Phoenix is located near Raja Indian Cuisine in the riverside area. It serves French food and has a high price range.
"name[The Phoenix], eatType[pub], food[French], priceRange[high], customer rating[3 out of 5], area[city centre], familyFriendly[no], near[Crowne Plaza Hotel]"	High priced French pub The Phoenix is located in the city centre near Crowne Plaza Hotel. It is not child friendly and has a customer rating of 3 out of 5.
"name[The Phoenix], eatType[pub], food[French], priceRange[high], customer rating[3 out of 5], area[city centre], familyFriendly[yes], near[Crowne Plaza Hotel]"	The Phoenix is a children friendly pub serving French food in the high price range with a customer rating of 3 out of 5. It is located in the city centre near Crowne Plaza Hotel.
"name[The Phoenix], eatType[pub], food[French], priceRange[high], customer rating[3 out of 5], area[riverside], familyFriendly[no], near[Crowne Plaza Hotel]"	The Phoenix is a pub that serves French food and is located in the riverside area near Crowne Plaza Hotel. It has a high price range and a customer rating of 3 out of 5. It is not children friendly.
"name[The Phoenix], eatType[pub], food[French], priceRange[high], customer rating[3 out of 5], area[riverside], familyFriendly[yes], near[Crowne Plaza Hotel]"	The Phoenix is a pub that serves French food and is children friendly. It is in the high price range and has a customer rating of 3 out of 5. It is located in the riverside area near Crowne Plaza Hotel.
"name[The Phoenix], eatType[pub], food[French], priceRange[less than £20], customer rating[average], area[city centre], familyFriendly[no], near[Crowne Plaza Hotel]"	The Phoenix is a pub that serves French food for less than £20. It is located in the city centre near Crowne Plaza Hotel. It has an average customer rating and is not family-friendly.
"name[The Phoenix], eatType[pub], food[French], priceRange[less than £20], customer rating[average], area[city centre], familyFriendly[yes], near[Crowne Plaza Hotel]"	"For a family-friendly pub with an average customer rating, The Phoenix is a pub that serves French food for less than £20. It is located in the city centre near Crowne Plaza Hotel."
"name[The Phoenix], eatType[pub], food[French], priceRange[less than £20], customer rating[average], area[riverside], familyFriendly[no], near[Crowne Plaza Hotel]"	In the riverside area near Crowne Plaza Hotel is a pub called The Phoenix. It serves French food and has an average customer rating. It is not family-friendly and has a price range of less than £20.
"name[The Phoenix], eatType[pub], food[French], priceRange[less than £20], customer rating[average], area[riverside], familyFriendly[yes], near[Crowne Plaza Hotel]"	Family friendly The Phoenix is a pub that serves French food and has an average customer rating. It is located in the riverside area near Crowne Plaza Hotel.
"name[The Phoenix], eatType[pub], food[French], priceRange[less than £20], customer rating[low], area[city centre], familyFriendly[no], near[Crowne Plaza Hotel]"	The Phoenixs is a pub that serves French food for less than £20. It is located in the city centre near Crowne Plaza Hotel. It is not family-friendly and has a low customer rating.
"name[The Phoenix], eatType[pub], food[French], priceRange[less than £20], customer rating[low], area[city centre], familyFriendly[yes], near[Crowne Plaza Hotel]"	"Although it has a low customer rating, The Phoenix is a family-friendly pub serving French food for less than £20. It is located in the city centre near Crowne Plaza Hotel."
"name[The Phoenix], eatType[pub], food[French], priceRange[less than £20], customer rating[low], area[riverside], familyFriendly[no], near[Crowne Plaza Hotel]"	In the riverside area near Crowne Plaza Hotel is a pub called The Phoenix. It serves French food and has a low customer rating. It is not family-friendly and has a price range of less than £20.
"name[The Phoenix], eatType[pub], food[French], priceRange[less than £20], customer rating[low], area[riverside], familyFriendly[yes], near[Crowne Plaza Hotel]"	On the riverside near Crowne Plaza Hotel is a pub called The Phoenix. It is family friendly and has a low customer rating and a price range of less than £20.
"name[The Phoenix], eatType[pub], food[French], priceRange[moderate], customer rating[1 out of 5], area[city centre], familyFriendly[no], near[Crowne Plaza Hotel]"	This pub is not kid friendly and is located in the city centre near Crowne Plaza Hotel.  It is called The Phoenix and serves French food. It has a moderate price range and a customer rating of 1 out of 5.
"name[The Phoenix], eatType[pub], food[French], priceRange[moderate], customer rating[1 out of 5], area[city centre], familyFriendly[yes], near[Crowne Plaza Hotel]"	The Phoenix is a pub that serves French food and is kid friendly. It is located in the city centre near Crowne Plaza Hotel. It has a moderate price range and a customer rating of 1 out of 5.
"name[The Phoenix], eatType[pub], food[French], priceRange[moderate], customer rating[1 out of 5], area[riverside], familyFriendly[no], near[Crowne Plaza Hotel]"	Crowne Plaza Hotel is a pub called The Phoenix that serves French food and is not kid friendly. It has a moderate price range and a customer rating of 1 out of 5. It is located in the riverside area.
"name[The Phoenix], eatType[pub], food[French], priceRange[moderate], customer rating[1 out of 5], area[riverside], familyFriendly[yes], near[Crowne Plaza Hotel]"	The Phoenix is a pub that serves French food and is kid friendly. It is located in the riverside area near Crowne Plaza Hotel. It has a moderate price range and a customer rating of 1 out of 5.
"name[The Phoenix], eatType[pub], food[French], priceRange[more than £30], customer rating[5 out of 5], area[city centre], familyFriendly[no], near[Crowne Plaza Hotel]"	"Rated 5 out of 5, The Phoenix is a pub that serves French food and is located in the city centre near Crowne Plaza Hotel. It is not children friendly and has a price range of more than £30."
"name[The Phoenix], eatType[pub], food[French], priceRange[more than £30], customer rating[5 out of 5], area[city centre], familyFriendly[yes], near[Crowne Plaza Hotel]"	The Phoenix is a children friendly pub serving French food with a price range of more than £30 and a customer rating of 5 out of 5. It is located in the city centre near Crowne Plaza Hotel.
"name[The Phoenix], eatType[pub], food[French], priceRange[more than £30], customer rating[5 out of 5], area[riverside], familyFriendly[no], near[Crowne Plaza Hotel]"	By the riverside near Crowne Plaza Hotel is a pub called The Phoenix. It serves French food and is not children friendly. It has a price range of more than £30 and a customer rating of 5 out of 5.
"name[The Phoenix], eatType[pub], food[French], priceRange[more than £30], customer rating[5 out of 5], area[riverside], familyFriendly[yes], near[Crowne Plaza Hotel]"	Children friendly French pub The Phoenix is located in riverside near Crowne Plaza Hotel. It has a price range of more than £30 and a customer rating of 5 out of 5.
"name[The Phoenix], eatType[pub], food[French], priceRange[more than £30], customer rating[low], area[city centre], familyFriendly[no], near[Crowne Plaza Hotel]"	There is a pub called The Phoenix that serves French food in the city centre near Crowne Plaza Hotel. It has a low customer rating and is not children friendly. It has a price range of more than £30.
"name[The Phoenix], eatType[pub], food[French], priceRange[more than £30], customer rating[low], area[city centre], familyFriendly[yes], near[Crowne Plaza Hotel]"	The Phoenix is a children friendly pub serving French food in the city centre near Crowne Plaza Hotel. It has a low customer rating and a price range of more than £30.
"name[The Phoenix], eatType[pub], food[French], priceRange[more than £30], customer rating[low], area[riverside], familyFriendly[no], near[Crowne Plaza Hotel]"	"Although not child friendly, The Phoenix is a pub that serves French food and is located in the riverside area near Crowne Plaza Hotel. It has a low customer rating and a price range of more than £30."
"name[The Phoenix], eatType[pub], food[French], priceRange[more than £30], customer rating[low], area[riverside], familyFriendly[yes], near[Crowne Plaza Hotel]"	Children friendly French pub The Phoenix has a low customer rating and a price range of more than £30. It is located in the riverside area near Crowne Plaza Hotel.
"name[The Phoenix], eatType[restaurant], food[Fast food], priceRange[cheap], area[riverside], familyFriendly[yes], near[Raja Indian Cuisine]"	There is a cheap restaurant The Phoenix located in riverside near Raja Indian Cuisine. It is family friendly.
"name[The Phoenix], eatType[restaurant], food[Fast food], priceRange[high], area[city centre], familyFriendly[no], near[Raja Indian Cuisine]"	"If you are looking for a high priced Fast food restaurant in the city centre, try The Phoenix. It is not children friendly."
"name[The Phoenix], eatType[restaurant], food[Fast food], priceRange[high], area[city centre], familyFriendly[yes], near[Raja Indian Cuisine]"	A children friendly restaurant named The Phoenix is located in the city centre near Raja Indian Cuisine. It serves Fast food and is in the high price range.
"name[The Phoenix], eatType[restaurant], food[Fast food], priceRange[high], area[riverside], familyFriendly[no], near[Raja Indian Cuisine]"	"If you are looking for a high priced restaurant in the riverside area, try The Phoenix. It is not children friendly and is located near Raja Indian Cuisine."
"name[The Phoenix], eatType[restaurant], food[Fast food], priceRange[high], area[riverside], familyFriendly[yes], near[Raja Indian Cuisine]"	Family friendly restaurant The Phoenix is located near Raja Indian Cuisine in the riverside area. It serves Fast food and has a high price range.
"name[The Phoenix], eatType[restaurant], food[Fast food], priceRange[less than £20], area[city centre], familyFriendly[no], near[Raja Indian Cuisine]"	Low priced Fast food restaurant The Phoenix is located in the city centre near Raja Indian Cuisine. It is not family-friendly.
"name[The Phoenix], eatType[restaurant], food[Fast food], priceRange[less than £20], area[city centre], familyFriendly[yes], near[Raja Indian Cuisine]"	The Phoenix is a family-friendly restaurant that serves Fast food for less than £20. It is located in the city centre near Raja Indian Cuisine.
"name[The Phoenix], eatType[restaurant], food[Fast food], priceRange[less than £20], area[riverside], familyFriendly[no], near[Raja Indian Cuisine]"	At the riverside near Raja Indian Cuisine is a Fast food restaurant called The Phoenix. It is not family-friendly and has a price range of less than £20.
"name[The Phoenix], eatType[restaurant], food[Fast food], priceRange[less than £20], area[riverside], familyFriendly[yes], near[Raja Indian Cuisine]"	There is a family friendly restaurant called The Phoenix located near Raja Indian Cuisine in the riverside area. It serves Fast food for less than £20.
"name[The Phoenix], eatType[restaurant], food[Fast food], priceRange[moderate], area[city centre], familyFriendly[no], near[Raja Indian Cuisine]"	Fast food restaurant The Phoenix is located in the city centre near Raja Indian Cuisine. It is not kid friendly and is moderately priced.
"name[The Phoenix], eatType[restaurant], food[Fast food], priceRange[moderate], area[city centre], familyFriendly[yes], near[Raja Indian Cuisine]"	A moderate priced Fast food restaurant in the city centre is The Phoenix. It is kid friendly and is located near Raja Indian Cuisine.
"name[The Phoenix], eatType[restaurant], food[Fast food], priceRange[moderate], area[riverside], familyFriendly[no], near[Raja Indian Cuisine]"	At the riverside near Raja Indian Cuisine is a moderately priced restaurant called The Phoenix. It is not kids friendly.
"name[The Phoenix], eatType[restaurant], food[Fast food], priceRange[moderate], area[riverside], familyFriendly[yes], near[Raja Indian Cuisine]"	A kid friendly restaurant named The Phoenix is located near Raja Indian Cuisine in the riverside area. It has a moderate price range.
"name[The Phoenix], eatType[restaurant], food[Fast food], priceRange[more than £30], area[riverside], familyFriendly[yes], near[Raja Indian Cuisine]"	There is a children friendly restaurant named The Phoenix in the riverside area near Raja Indian Cuisine with a price range of more than £30.
"name[The Phoenix], eatType[restaurant], food[French], priceRange[£20-25], area[riverside], familyFriendly[yes], near[Raja Indian Cuisine]"	By the riverside and near Raja Indian Cuisine is a kid friendly restaurant called The Phoenix. It has a price range of £20-25.
"name[The Phoenix], eatType[restaurant], food[French], priceRange[cheap], area[riverside], familyFriendly[yes], near[Raja Indian Cuisine]"	At the riverside near Raja Indian Cuisine is a cheap family friendly restaurant called The Phoenix.
"name[The Phoenix], eatType[restaurant], food[French], priceRange[high], area[riverside], familyFriendly[yes], near[Raja Indian Cuisine]"	A children friendly restaurant named The Phoenix is located in the riverside area near Raja Indian Cuisine. It has a high price range.
"name[The Phoenix], eatType[restaurant], food[Indian], priceRange[£20-25], customer rating[high], area[city centre], familyFriendly[no], near[Crowne Plaza Hotel]"	Coffee shop The Phoenix is a Indian restaurant with a high customer rating and a price range of £20-25. It is located in the city centre and is not kid friendly.
"name[The Phoenix], eatType[restaurant], food[Indian], priceRange[£20-25], customer rating[high], area[city centre], familyFriendly[yes], near[Crowne Plaza Hotel]"	A high rated Indian restaurant in the city centre near Crowne Plaza Hotel is The Phoenix. It is kids friendly and has a price range of £20-25.
"name[The Phoenix], eatType[restaurant], food[Indian], priceRange[£20-25], customer rating[high], area[riverside], familyFriendly[no], near[Crowne Plaza Hotel]"	"Located in the riverside area near Crowne Plaza Hotel, The Phoenix is a restaurant with a high customer rating and a price range of £20-25."
"name[The Phoenix], eatType[restaurant], food[Indian], priceRange[£20-25], customer rating[high], area[riverside], familyFriendly[yes], near[Crowne Plaza Hotel]"	Riverside has a high rated kid friendly restaurant named The Phoenix near Crowne Plaza Hotel. It has a price range of £20-25.
"name[The Phoenix], eatType[restaurant], food[Indian], priceRange[cheap], customer rating[5 out of 5], area[city centre], familyFriendly[no], near[Crowne Plaza Hotel]"	This restaurant is located in the city centre near the Crowne Plaza Hotel and is called The Phoenix. It serves Indian food and is cheap. It has a customer rating of 5 out of 5.
"name[The Phoenix], eatType[restaurant], food[Indian], priceRange[cheap], customer rating[5 out of 5], area[city centre], familyFriendly[yes], near[Crowne Plaza Hotel]"	This restaurant is located in the city centre near Crowne Plaza Hotel and is child friendly and has a customer rating of 5 out of 5 is The Phoenix.  It serves Indian food and has a cheap price range.
"name[The Phoenix], eatType[restaurant], food[Indian], priceRange[cheap], customer rating[5 out of 5], area[riverside], familyFriendly[no], near[Crowne Plaza Hotel]"	The Phoenix is a cheap Indian restaurant located in riverside near Crowne Plaza Hotel. It is not family-friendly and has a customer rating of 5 out of 5.
"name[The Phoenix], eatType[restaurant], food[Indian], priceRange[cheap], customer rating[5 out of 5], area[riverside], familyFriendly[no], near[Express by Holiday Inn]"	The Phoenix is a cheap Indian restaurant located in riverside near Express by Holiday Inn. It is not family-friendly and has a customer rating of 5 out of 5.
"name[The Phoenix], eatType[restaurant], food[Indian], priceRange[cheap], customer rating[5 out of 5], area[riverside], familyFriendly[yes], near[Express by Holiday Inn]"	At the riverside there is a cheap restaurant called The Phoenix that is family friendly and serves Indian food. It is located near Express by Holiday Inn.
"name[The Phoenix], eatType[restaurant], food[Indian], priceRange[cheap], customer rating[average], area[city centre], familyFriendly[no], near[Express by Holiday Inn]"	"If you are looking for a cheap Indian restaurant that is not family-friendly, try The Phoenix. It is located in the city centre area and is near the Express by Holiday Inn."
"name[The Plough], eatType[pub], food[Chinese], priceRange[£20-25], area[riverside], familyFriendly[yes], near[Raja Indian Cuisine]"	By the riverside near Raja Indian Cuisine is a kids friendly pub called The Plough which serves Chinese food and has a price range of £20-25.
"name[The Plough], eatType[pub], food[Chinese], priceRange[cheap], area[riverside], familyFriendly[yes], near[Raja Indian Cuisine]"	Riverside pub The Plough is a cheap family friendly Chinese pub near Raja Indian Cuisine.
"name[The Plough], eatType[pub], food[Chinese], priceRange[high], area[city centre], familyFriendly[no], near[Raja Indian Cuisine]"	The Ploughs is a pub that serves Chinese food in the high price range and is located in the city centre near Raja Indian Cuisine. It is not children friendly.
"name[The Plough], eatType[pub], food[Chinese], priceRange[high], area[city centre], familyFriendly[yes], near[Raja Indian Cuisine]"	The Ploughs is a pub that serves Chinese food and is located in the city centre near Raja Indian Cuisine. It is children friendly and has a high price range.
"name[The Plough], eatType[pub], food[Chinese], priceRange[high], area[riverside], familyFriendly[no], near[Raja Indian Cuisine]"	Raja Indian Cuisine is near the riverside area and is a pub called The Plough. It serves Chinese food and is not children friendly. It has a high price range.
"name[The Plough], eatType[pub], food[Chinese], priceRange[high], area[riverside], familyFriendly[yes], near[Raja Indian Cuisine]"	On the riverside near Raja Indian Cuisine is a child friendly pub called The Plough. It serves Chinese food and has a high price range.
"name[The Plough], eatType[pub], food[Chinese], priceRange[less than £20], area[city centre], familyFriendly[no], near[Raja Indian Cuisine]"	There is a pub called The Plough that serves Chinese food for less than £20. It is located in the city centre near Raja Indian Cuisine and is not family-friendly.
"name[The Plough], eatType[restaurant], food[Chinese], priceRange[£20-25], area[riverside], familyFriendly[yes], near[Raja Indian Cuisine]"	Family friendly restaurant The Plough is located near Raja Indian Cuisine in the riverside area. It serves Chinese food and has a price range of £20-25.
"name[The Plough], eatType[restaurant], food[Chinese], priceRange[cheap], area[riverside], familyFriendly[yes], near[Raja Indian Cuisine]"	"Situated in the riverside area near Raja Indian Cuisine, The Plough is a family friendly restaurant that serves cheap Chinese food."
"name[The Plough], eatType[restaurant], food[Chinese], priceRange[high], area[city centre], familyFriendly[no], near[Raja Indian Cuisine]"	A Chinese restaurant named The Plough is located in the city centre near Raja Indian Cuisine. It is not children friendly and is in the high price range.
"name[The Plough], eatType[restaurant], food[Chinese], priceRange[high], area[city centre], familyFriendly[yes], near[Raja Indian Cuisine]"	A children friendly restaurant named The Plough is located in the city centre near Raja Indian Cuisine. It serves Chinese food and is in the high price range.
"name[The Plough], eatType[restaurant], food[Chinese], priceRange[high], area[riverside], familyFriendly[no], near[Raja Indian Cuisine]"	"If you are looking for a high priced restaurant in the riverside area, try The Plough. It is not children friendly and is located near Raja Indian Cuisine."
"name[The Plough], eatType[restaurant], food[Chinese], priceRange[high], area[riverside], familyFriendly[yes], near[Raja Indian Cuisine]"	Family friendly restaurant The Plough is located near Raja Indian Cuisine in the riverside area. It serves Chinese food and has a high price range.
"name[The Plough], eatType[restaurant], food[Chinese], priceRange[less than £20], area[city centre], familyFriendly[no], near[Raja Indian Cuisine]"	In the city centre near Raja Indian Cuisine is a Chinese restaurant called The Plough. It is not family-friendly and has a price range of less than £20.
"name[The Punter], eatType[pub], food[Chinese], priceRange[less than £20], area[city centre], familyFriendly[yes], near[Raja Indian Cuisine]"	"Situated in the city centre near Raja Indian Cuisine, The Punter is a family-friendly pub that serves Chinese food for less than £20."
"name[The Punter], eatType[pub], food[Chinese], priceRange[less than £20], area[riverside], familyFriendly[no], near[Raja Indian Cuisine]"	On the riverside near Raja Indian Cuisine is a pub called The Punter. It serves Chinese food for less than £20. It is not family-friendly.
"name[The Punter], eatType[pub], food[Chinese], priceRange[less than £20], area[riverside], familyFriendly[yes], near[Raja Indian Cuisine]"	"Situated near Raja Indian Cuisine in the riverside area, The Punter is a family friendly pub that serves Chinese food for less than £20."
"name[The Punter], eatType[pub], food[Chinese], priceRange[moderate], area[city centre], familyFriendly[no], near[Raja Indian Cuisine]"	A Chinese pub named The Punter is located in the city centre near Raja Indian Cuisine. It is not kid friendly and has a moderate price range.
"name[The Punter], eatType[pub], food[Chinese], priceRange[moderate], area[city centre], familyFriendly[yes], near[Raja Indian Cuisine]"	"Situated in the city centre near Raja Indian Cuisine, The Punter is a kid friendly pub that serves Chinese food at a moderate price."
"name[The Punter], eatType[pub], food[Chinese], priceRange[moderate], area[riverside], familyFriendly[no], near[Raja Indian Cuisine]"	There is a moderately priced Chinese pub near Raja Indian Cuisine in riverside called The Punter. It is not kid friendly.
"name[The Punter], eatType[pub], food[Chinese], priceRange[moderate], area[riverside], familyFriendly[yes], near[Raja Indian Cuisine]"	A pub named The Punter is located near Raja Indian Cuisine in the riverside area. It is kid friendly and serves Chinese food at a moderate price.
"name[The Punter], eatType[pub], food[Chinese], priceRange[more than £30], area[riverside], familyFriendly[yes], near[Raja Indian Cuisine]"	On the riverside near Raja Indian Cuisine is a child friendly pub called The Punter which serves Chinese food and has a price range of more than £30.
"name[The Punter], eatType[pub], food[English], priceRange[£20-25], area[riverside], familyFriendly[yes], near[Raja Indian Cuisine]"	There is a pub named The Punter that serves English food and is kid friendly. It is located in riverside near Raja Indian Cuisine. The price range is £20-25.
"name[The Punter], eatType[pub], food[English], priceRange[cheap], area[riverside], familyFriendly[yes], near[Raja Indian Cuisine]"	"If you're looking for a cheap family friendly pub in the riverside area, try The Punter. It serves English food and is located near Raja Indian Cuisine."
"name[The Punter], eatType[pub], food[English], priceRange[high], area[city centre], familyFriendly[no], near[Raja Indian Cuisine]"	In the city centre near Raja Indian Cuisine is a pub called The Punter. It serves English food and is not children friendly. It has a high price range.
"name[The Punter], eatType[pub], food[English], priceRange[high], area[city centre], familyFriendly[yes], near[Raja Indian Cuisine]"	The Punter is a pub that serves English food in the high price range and is children friendly. It is located in the city centre near Raja Indian Cuisine.
"name[The Punter], eatType[pub], food[English], priceRange[high], area[riverside], familyFriendly[no], near[Raja Indian Cuisine]"	There is a pub called The Punter that serves English food and is located near Raja Indian Cuisine in the riverside area. It is not children friendly and has a high price range.
"name[The Punter], eatType[pub], food[English], priceRange[high], area[riverside], familyFriendly[yes], near[Raja Indian Cuisine]"	Riverside has a children friendly pub near Raja Indian Cuisine called The Punter which serves English food and has a high price range.
"name[The Punter], eatType[pub], food[Italian], priceRange[high], customer rating[average], area[city centre], familyFriendly[no], near[Rainbow Vegetarian Café]"	The Punter is a pub that serves Italian food in the high price range. It is located in the city centre near Rainbow Vegetarian Café. It is not children friendly and has an average customer rating.
"name[The Punter], eatType[restaurant], food[Chinese], priceRange[less than £20], area[city centre], familyFriendly[yes], near[Raja Indian Cuisine]"	The Punter is a family-friendly restaurant that serves Chinese food for less than £20. It is located in the city centre near Raja Indian Cuisine.
"name[The Punter], eatType[restaurant], food[Chinese], priceRange[less than £20], area[riverside], familyFriendly[no], near[Raja Indian Cuisine]"	In the riverside area near Raja Indian Cuisine is a Chinese restaurant called The Punter. It is not family-friendly and has a price range of less than £20.
"name[The Punter], eatType[restaurant], food[Chinese], priceRange[less than £20], area[riverside], familyFriendly[yes], near[Raja Indian Cuisine]"	There is a family friendly restaurant called The Punter located near Raja Indian Cuisine in the riverside area. It serves Chinese food for less than £20.
"name[The Punter], eatType[restaurant], food[Chinese], priceRange[moderate], area[city centre], familyFriendly[no], near[Raja Indian Cuisine]"	"For a moderate priced Chinese restaurant in the city centre near Raja Indian Cuisine, try The Punter. It is not kid friendly."
"name[The Punter], eatType[restaurant], food[Chinese], priceRange[moderate], area[city centre], familyFriendly[yes], near[Raja Indian Cuisine]"	A moderate priced Chinese restaurant in the city centre is The Punter. It is kid friendly and is located near Raja Indian Cuisine.
"name[The Punter], eatType[restaurant], food[Chinese], priceRange[moderate], area[riverside], familyFriendly[no], near[Raja Indian Cuisine]"	In the riverside area near Raja Indian Cuisine is a moderately priced restaurant called The Punter. It is not kid friendly.
"name[The Punter], eatType[restaurant], food[Chinese], priceRange[moderate], area[riverside], familyFriendly[yes], near[Raja Indian Cuisine]"	The Punter is a moderately priced restaurant that serves Chinese food and is kid friendly. It is located in the riverside area near Raja Indian Cuisine.
"name[The Punter], eatType[restaurant], food[Chinese], priceRange[more than £30], area[riverside], familyFriendly[yes], near[Raja Indian Cuisine]"	Next to Raja Indian Cuisine is a child friendly restaurant called The Punter. It serves Chinese food and has a price range of more than £30.
"name[The Punter], eatType[restaurant], food[English], priceRange[£20-25], area[riverside], familyFriendly[yes], near[Raja Indian Cuisine]"	The Punter is a kid friendly restaurant in the riverside area near Raja Indian Cuisine with a price range of £20-25.
"name[The Punter], eatType[restaurant], food[English], priceRange[cheap], area[riverside], familyFriendly[yes], near[Raja Indian Cuisine]"	Cheap English food in a family friendly restaurant called The Punter in the riverside area.
"name[The Punter], eatType[restaurant], food[English], priceRange[high], area[city centre], familyFriendly[no], near[Raja Indian Cuisine]"	English restaurant The Punter is located in the city centre near Raja Indian Cuisine. It is not children friendly and is in the high price range.
"name[The Punter], eatType[restaurant], food[English], priceRange[high], area[city centre], familyFriendly[yes], near[Raja Indian Cuisine]"	There is a high priced English restaurant called The Punter located in the city centre near Raja Indian Cuisine. It is children friendly.
"name[The Punter], eatType[restaurant], food[English], priceRange[high], area[riverside], familyFriendly[no], near[Raja Indian Cuisine]"	There is a high priced English restaurant called The Punter in the riverside area near Raja Indian Cuisine. It is not children friendly.
"name[The Punter], eatType[restaurant], food[English], priceRange[high], area[riverside], familyFriendly[yes], near[Raja Indian Cuisine]"	If you are looking for a children friendly restaurant in the riverside area then try The Punter. It is near Raja Indian Cuisine and is in the high price range.
"name[The Punter], eatType[restaurant], food[Indian], priceRange[cheap], customer rating[average], area[city centre], familyFriendly[yes], near[Express by Holiday Inn]"	Family friendly restaurant The Punter is located in the city centre near Express by Holiday Inn. It has an average customer rating and is cheap.
"name[The Punter], eatType[restaurant], food[Indian], priceRange[cheap], customer rating[average], area[riverside], familyFriendly[no], near[Express by Holiday Inn]"	Coffee shop The Punter is a restaurant that serves Indian food and is not family-friendly. It has an average customer rating and is cheap. It is located in the riverside area.
"name[The Punter], eatType[restaurant], food[Indian], priceRange[cheap], customer rating[average], area[riverside], familyFriendly[yes], near[Express by Holiday Inn]"	Riverside restaurant The Punter is a family friendly restaurant with an average customer rating and a cheap price range. It is located near Express by Holiday Inn.
"name[The Punter], eatType[restaurant], food[Indian], priceRange[high], customer rating[1 out of 5], area[city centre], familyFriendly[no], near[Express by Holiday Inn]"	High priced Indian restaurant The Punter is located in the city centre near Express by Holiday Inn. It is not children friendly and has a customer rating of 1 out of 5.
"name[The Punter], eatType[restaurant], food[Indian], priceRange[high], customer rating[1 out of 5], area[city centre], familyFriendly[yes], near[Express by Holiday Inn]"	The Punter is a children friendly restaurant with a high price range and a customer rating of 1 out of 5. It is located in the city centre near Express by Holiday Inn.
"name[The Punter], eatType[restaurant], food[Indian], priceRange[high], customer rating[1 out of 5], area[riverside], familyFriendly[no], near[Express by Holiday Inn]"	There is a high priced restaurant The Punter located in the riverside area near Express by Holiday Inn. It is not children friendly and has a customer rating of 1 out of 5.
"name[The Punter], eatType[restaurant], food[Indian], priceRange[high], customer rating[1 out of 5], area[riverside], familyFriendly[yes], near[Express by Holiday Inn]"	There is a high priced restaurant The Punter located in the riverside area near Express by Holiday Inn. It is children friendly and has a customer rating of 1 out of 5.
"name[The Punter], eatType[restaurant], food[Indian], priceRange[high], customer rating[average], area[city centre], familyFriendly[no], near[Express by Holiday Inn]"	Express by Holiday Inn is a high priced restaurant called The Punter that serves Indian food and is not children friendly. It is located in the city centre.
"name[The Punter], eatType[restaurant], food[Indian], priceRange[high], customer rating[average], area[city centre], familyFriendly[yes], near[Express by Holiday Inn]"	A children friendly restaurant named The Punter is located in the city centre near Express by Holiday Inn. It has an average customer rating and a high price range.
"name[The Punter], eatType[restaurant], food[Indian], priceRange[high], customer rating[average], area[riverside], familyFriendly[no], near[Express by Holiday Inn]"	Coffee shop The Punter is a high priced restaurant in the riverside area that serves Indian food. It is not children friendly and has an average customer rating.
"name[The Punter], eatType[restaurant], food[Indian], priceRange[high], customer rating[average], area[riverside], familyFriendly[yes], near[Express by Holiday Inn]"	The Punter is a children friendly restaurant in the riverside area near Express by Holiday Inn with an average customer rating and a high price range.
"name[The Punter], eatType[restaurant], food[Indian], priceRange[less than £20], customer rating[low], area[city centre], familyFriendly[no], near[Express by Holiday Inn]"	An Indian restaurant named The Punter is located in the city centre near Express by Holiday Inn. It is not family-friendly and has a price range of less than £20.
"name[The Punter], eatType[restaurant], food[Indian], priceRange[less than £20], customer rating[low], area[city centre], familyFriendly[yes], near[Express by Holiday Inn]"	There is a family-friendly restaurant named The Punter in the city centre near Express by Holiday Inn with a low customer rating and a price range of less than £20.
"name[The Punter], eatType[restaurant], food[Indian], priceRange[less than £20], customer rating[low], area[riverside], familyFriendly[no], near[Express by Holiday Inn]"	There is a cheap restaurant The Punter located near Express by Holiday Inn that provides Indian food. It is not family-friendly and has a low customer rating.
"name[The Punter], eatType[restaurant], food[Indian], priceRange[less than £20], customer rating[low], area[riverside], familyFriendly[yes], near[Express by Holiday Inn]"	Located near Express by Holiday Inn is a family friendly restaurant called The Punter. It has a low customer rating and a price range of less than £20.
"name[The Punter], eatType[restaurant], food[Indian], priceRange[moderate], customer rating[1 out of 5], area[city centre], familyFriendly[no], near[Express by Holiday Inn]"	An Indian restaurant named The Punter is located in the city centre near Express by Holiday Inn. It is not kid friendly and has a moderate price range.
"name[The Punter], eatType[restaurant], food[Indian], priceRange[moderate], customer rating[1 out of 5], area[city centre], familyFriendly[yes], near[Express by Holiday Inn]"	There is a moderate priced restaurant The Punter located in the city centre near Express by Holiday Inn that is kid friendly and has a customer rating of 1 out of 5.
"name[The Punter], eatType[restaurant], food[Indian], priceRange[moderate], customer rating[1 out of 5], area[riverside], familyFriendly[no], near[Express by Holiday Inn]"	On the riverside near Express by Holiday Inn is a moderately priced restaurant called The Punter. It is not kids friendly.
"name[The Punter], eatType[restaurant], food[Indian], priceRange[moderate], customer rating[1 out of 5], area[riverside], familyFriendly[yes], near[Express by Holiday Inn]"	On the riverside near Express by Holiday Inn is a kid friendly restaurant called The Punter. It has a moderate price range.
"name[The Punter], eatType[restaurant], food[Indian], priceRange[moderate], customer rating[3 out of 5], area[city centre], familyFriendly[no], near[Express by Holiday Inn]"	There is a moderate priced restaurant The Punter located in the city centre near Express by Holiday Inn. It is not kids friendly and has a customer rating of 3 out of 5.
"name[The Punter], eatType[restaurant], food[Indian], priceRange[moderate], customer rating[3 out of 5], area[city centre], familyFriendly[yes], near[Express by Holiday Inn]"	This restaurant is called The Punter and is located in the city centre near Express by Holiday Inn. It is kids friendly and has a customer rating of 3 out of 5. It serves Indian food.
"name[The Punter], eatType[restaurant], food[Indian], priceRange[moderate], customer rating[3 out of 5], area[riverside], familyFriendly[no], near[Express by Holiday Inn]"	Moderately priced Indian restaurant The Punter is located in riverside near Express by Holiday Inn. It is not kid friendly.
"name[The Punter], eatType[restaurant], food[Indian], priceRange[moderate], customer rating[3 out of 5], area[riverside], familyFriendly[yes], near[Express by Holiday Inn]"	On the riverside near Express by Holiday Inn is a kid friendly restaurant called The Punter. It has a customer rating of 3 out of 5.
"name[The Punter], eatType[restaurant], food[Indian], priceRange[more than £30], customer rating[high], area[city centre], familyFriendly[no], near[Express by Holiday Inn]"	In the city centre near Express by Holiday Inn is a high rated restaurant called The Punter. It is not children friendly and has a price range of more than £30.
"name[The Punter], eatType[restaurant], food[Indian], priceRange[more than £30], customer rating[high], area[city centre], familyFriendly[yes], near[Express by Holiday Inn]"	A children friendly restaurant named The Punter is located near Express by Holiday Inn in the city centre. It has a high customer rating and a price range of more than £30.
"name[The Punter], eatType[restaurant], food[Indian], priceRange[more than £30], customer rating[high], area[riverside], familyFriendly[no], near[Express by Holiday Inn]"	The Punter is a high rated restaurant in the riverside area near Express by Holiday Inn. It is not children friendly and the price range is more than £30.
"name[The Punter], eatType[restaurant], food[Indian], priceRange[more than £30], customer rating[high], area[riverside], familyFriendly[yes], near[Express by Holiday Inn]"	High rated Indian restaurant The Punter is located in riverside near Express by Holiday Inn. It is children friendly.
"name[The Punter], eatType[restaurant], food[Italian], priceRange[£20-25], customer rating[high], area[city centre], familyFriendly[no], near[Express by Holiday Inn]"	In the city centre near Express by Holiday Inn is a restaurant called The Punter. It is not kid friendly and has a high customer rating. The price range is £20-25.
"name[The Punter], eatType[restaurant], food[Italian], priceRange[£20-25], customer rating[high], area[city centre], familyFriendly[yes], near[Express by Holiday Inn]"	There is a high rated Italian restaurant called The Punter in the city centre near Express by Holiday Inn. It is kids friendly and has a price range of £20-25.
"name[The Punter], eatType[restaurant], food[Italian], priceRange[£20-25], customer rating[high], area[riverside], familyFriendly[no], near[Express by Holiday Inn]"	Express by Holiday Inn is a restaurant named The Punter that serves Italian food and has a high customer rating. It is not kid friendly and is in the riverside area.
"name[The Punter], eatType[restaurant], food[Italian], priceRange[£20-25], customer rating[high], area[riverside], familyFriendly[yes], near[Express by Holiday Inn]"	High rated Italian restaurant The Punter is located in riverside near Express by Holiday Inn. It is kids friendly and has a price range of £20-25.
"name[The Punter], eatType[restaurant], food[Italian], priceRange[cheap], customer rating[5 out of 5], area[city centre], familyFriendly[no], near[Express by Holiday Inn]"	Located in the city centre near Express by Holiday Inn is a restaurant called The Punter which serves Italian food. It is not family-friendly and has a customer rating of 5 out of 5.
"name[The Punter], eatType[restaurant], food[Italian], priceRange[cheap], customer rating[5 out of 5], area[city centre], familyFriendly[no], near[Rainbow Vegetarian Café]"	An Italian restaurant named The Punter is located in the city centre near Rainbow Vegetarian Café. It is not family-friendly and has a customer rating of 5 out of 5.
"name[The Punter], eatType[restaurant], food[Italian], priceRange[cheap], customer rating[5 out of 5], area[city centre], familyFriendly[yes], near[Rainbow Vegetarian Café]"	A cheap Italian restaurant in the city centre is The Punter. It is family-friendly and has a customer rating of 5 out of 5.
"name[The Punter], eatType[restaurant], food[Italian], priceRange[cheap], customer rating[5 out of 5], area[riverside], familyFriendly[no], near[Rainbow Vegetarian Café]"	The Punter is a restaurant that serves Italian food and is located near Rainbow Vegetarian Café in the riverside area. It is not family-friendly and has a customer rating of 5 out of 5.
"name[The Punter], eatType[restaurant], food[Italian], priceRange[cheap], customer rating[5 out of 5], area[riverside], familyFriendly[yes], near[Rainbow Vegetarian Café]"	At the riverside there is a cheap restaurant called The Punter that is family friendly and serves Italian food. It is located near Rainbow Vegetarian Café.
"name[The Punter], eatType[restaurant], food[Italian], priceRange[cheap], customer rating[average], area[city centre], familyFriendly[no], near[Rainbow Vegetarian Café]"	The Punter is a restaurant that serves Italian food and is located in the city centre near Rainbow Vegetarian Café. It has an average customer rating and is cheap.
"name[The Punter], eatType[restaurant], food[Italian], priceRange[cheap], customer rating[average], area[city centre], familyFriendly[yes], near[Rainbow Vegetarian Café]"	Family friendly restaurant The Punter is located in the city centre near Rainbow Vegetarian Café. It has an average customer rating and is cheap.
"name[The Punter], eatType[restaurant], food[Italian], priceRange[cheap], customer rating[average], area[riverside], familyFriendly[no], near[Rainbow Vegetarian Café]"	Coffee shop The Punter is a restaurant that serves Italian food and is not family-friendly. It has an average customer rating and is cheap. It is located in the riverside area.
"name[The Punter], eatType[restaurant], food[Italian], priceRange[cheap], customer rating[average], area[riverside], familyFriendly[yes], near[Rainbow Vegetarian Café]"	Riverside restaurant The Punter is a family friendly restaurant with an average customer rating and a cheap price range. It is located near Rainbow Vegetarian Café.
"name[The Punter], eatType[restaurant], food[Italian], priceRange[high], customer rating[1 out of 5], area[city centre], familyFriendly[no], near[Rainbow Vegetarian Café]"	Rainbow Vegetarian Café is a high priced restaurant called The Punter that serves Italian food and is not child friendly and is rated 1 out of 5 by customers.
"name[The Punter], eatType[restaurant], food[Italian], priceRange[high], customer rating[1 out of 5], area[city centre], familyFriendly[yes], near[Rainbow Vegetarian Café]"	The Punter is a children friendly restaurant that serves Italian food and is located in the city centre near Rainbow Vegetarian Café. It has a high price range.
"name[The Punter], eatType[restaurant], food[Italian], priceRange[high], customer rating[1 out of 5], area[riverside], familyFriendly[no], near[Rainbow Vegetarian Café]"	Coffee shop The Punter is a high priced restaurant in the riverside area near Rainbow Vegetarian Café. It is not child friendly and has a customer rating of 1 out of 5.
"name[The Punter], eatType[restaurant], food[Italian], priceRange[high], customer rating[1 out of 5], area[riverside], familyFriendly[yes], near[Rainbow Vegetarian Café]"	Riverside has a children friendly restaurant named The Punter with a high price range and a customer rating of 1 out of 5. It is located near Rainbow Vegetarian Café.
"name[The Vaults], eatType[pub], food[French], priceRange[high], area[riverside], familyFriendly[yes], near[Raja Indian Cuisine]"	The Vaults is a pub that serves French food and is located near Raja Indian Cuisine in the riverside area. It is children friendly and has a high price range.
"name[The Vaults], eatType[pub], food[French], priceRange[less than £20], area[city centre], familyFriendly[no], near[Raja Indian Cuisine]"	The Vaults is a pub that serves French food for less than £20. It is located in the city centre near Raja Indian Cuisine and is not family-friendly.
"name[The Vaults], eatType[pub], food[French], priceRange[less than £20], area[city centre], familyFriendly[yes], near[Raja Indian Cuisine]"	Children friendly pub The Vaults serves French food for less than £20. It is located in the city centre near Raja Indian Cuisine.
"name[The Vaults], eatType[pub], food[French], priceRange[less than £20], area[riverside], familyFriendly[no], near[Raja Indian Cuisine]"	For a pub serving French food in the riverside area then try The Vaults. It is near Raja Indian Cuisine and is not family-friendly. Prices are less than £20.
"name[The Vaults], eatType[pub], food[French], priceRange[less than £20], area[riverside], familyFriendly[yes], near[Raja Indian Cuisine]"	Family friendly pub The Vaults is located near Raja Indian Cuisine in the riverside area. It serves French food for less than £20.
"name[The Vaults], eatType[pub], food[French], priceRange[moderate], area[city centre], familyFriendly[no], near[Raja Indian Cuisine]"	The Vaults is a pub that serves French food in the moderate price range. It is located in the city centre near Raja Indian Cuisine and is not kid friendly.
"name[The Vaults], eatType[pub], food[French], priceRange[moderate], area[city centre], familyFriendly[yes], near[Raja Indian Cuisine]"	"Situated in the city centre near Raja Indian Cuisine, The Vaults is a kid friendly pub that serves French food at a moderate price."
"name[The Vaults], eatType[pub], food[French], priceRange[moderate], area[riverside], familyFriendly[no], near[Raja Indian Cuisine]"	Moderately priced French food is served at The Vaults pub near Raja Indian Cuisine in riverside. It is not kid friendly.
"name[The Vaults], eatType[pub], food[French], priceRange[moderate], area[riverside], familyFriendly[yes], near[Raja Indian Cuisine]"	"Located near Raja Indian Cuisine in the riverside area, The Vaults is a kid friendly pub that serves French food at a moderate price."
"name[The Vaults], eatType[pub], food[French], priceRange[more than £30], area[city centre], familyFriendly[no], near[Raja Indian Cuisine]"	French food is served at The Vaults pub in the city centre near Raja Indian Cuisine. It is not children friendly and has a price range of more than £30.
"name[The Vaults], eatType[pub], food[French], priceRange[more than £30], area[city centre], familyFriendly[yes], near[Raja Indian Cuisine]"	The Vaults is a children friendly pub serving French food in the city centre near Raja Indian Cuisine. It has a price range of more than £30.
"name[The Vaults], eatType[pub], food[French], priceRange[more than £30], area[riverside], familyFriendly[no], near[Raja Indian Cuisine]"	"Serving French food in the riverside area near Raja Indian Cuisine, The Vaults is a pub with a price range of more than £30. It is not children friendly."
"name[The Vaults], eatType[pub], food[French], priceRange[more than £30], area[riverside], familyFriendly[yes], near[Raja Indian Cuisine]"	On the riverside near Raja Indian Cuisine is a child friendly pub called The Vaults which serves French food and has a price range of more than £30.
"name[The Vaults], eatType[pub], food[Indian], priceRange[£20-25], area[riverside], familyFriendly[yes], near[Raja Indian Cuisine]"	On the riverside near Raja Indian Cuisine is a kids friendly pub called The Vaults which serves Indian food and has a price range of £20-25.
"name[The Vaults], eatType[pub], food[Indian], priceRange[cheap], area[riverside], familyFriendly[yes], near[Raja Indian Cuisine]"	Children friendly pub The Vaults serves cheap Indian food near Raja Indian Cuisine in the riverside area.
"name[The Vaults], eatType[pub], food[Indian], priceRange[high], area[city centre], familyFriendly[no], near[Raja Indian Cuisine]"	"Serving Indian food in the high price range, The Vaults is a pub located in the city centre near Raja Indian Cuisine. It is not children friendly."
"name[The Vaults], eatType[pub], food[Indian], priceRange[high], area[city centre], familyFriendly[yes], near[Raja Indian Cuisine]"	The Vaultss is a pub that serves Indian food and is located in the city centre near Raja Indian Cuisine. It is children friendly and has a high price range.
"name[The Vaults], eatType[pub], food[Italian], priceRange[high], customer rating[average], area[city centre], familyFriendly[no], near[Rainbow Vegetarian Café]"	The Vaults is a pub that serves Italian food in the high price range with an average customer rating and is not children friendly. It is located in the city centre near Rainbow Vegetarian Café.
"name[The Vaults], eatType[pub], food[Italian], priceRange[high], customer rating[average], area[city centre], familyFriendly[yes], near[Rainbow Vegetarian Café]"	High priced Italian pub The Vaults is located in the city centre near Rainbow Vegetarian Café. It is children friendly and has an average customer rating.
"name[The Vaults], eatType[pub], food[Italian], priceRange[high], customer rating[average], area[riverside], familyFriendly[no], near[Rainbow Vegetarian Café]"	On the riverside near Rainbow Vegetarian Café is a pub called The Vaults. It serves Italian food and is not children friendly. It has a high price range and an average customer rating.
"name[The Vaults], eatType[pub], food[Italian], priceRange[high], customer rating[average], area[riverside], familyFriendly[yes], near[Rainbow Vegetarian Café]"	The Vaults is a pub that serves Italian food and is children friendly. It is in the high price range and has an average customer rating. It is located in the riverside area near Rainbow Vegetarian Café.
"name[The Vaults], eatType[pub], food[Italian], priceRange[less than £20], customer rating[low], area[city centre], familyFriendly[no], near[Rainbow Vegetarian Café]"	The Vaults is a pub that serves Italian food for less than £20. It is located in the city centre near Rainbow Vegetarian Café. It is not family-friendly and has a low customer rating.
"name[The Vaults], eatType[pub], food[Italian], priceRange[less than £20], customer rating[low], area[city centre], familyFriendly[yes], near[Rainbow Vegetarian Café]"	"Although it has a low customer rating, The Vaults is a family-friendly pub serving Italian food for less than £20. It is located in the city centre near Rainbow Vegetarian Café."
"name[The Vaults], eatType[pub], food[Italian], priceRange[less than £20], customer rating[low], area[riverside], familyFriendly[no], near[Rainbow Vegetarian Café]"	Low priced Italian food is served at The Vaults pub located in the riverside area near Rainbow Vegetarian Café. It is not family-friendly and has a low customer rating.
"name[The Vaults], eatType[pub], food[Italian], priceRange[less than £20], customer rating[low], area[riverside], familyFriendly[yes], near[Rainbow Vegetarian Café]"	The Vaults is a family friendly pub located near Rainbow Vegetarian Café in the riverside area. It serves Italian food and has a low customer rating.
"name[The Vaults], eatType[pub], food[Italian], priceRange[moderate], customer rating[1 out of 5], area[city centre], familyFriendly[no], near[Rainbow Vegetarian Café]"	In the city centre near Rainbow Vegetarian Café is a pub called The Vaults. It serves Italian food and has a moderate price range. It is not kid friendly and has a customer rating of 1 out of 5.
"name[The Vaults], eatType[pub], food[Italian], priceRange[moderate], customer rating[1 out of 5], area[city centre], familyFriendly[yes], near[Rainbow Vegetarian Café]"	The Vaults is a pub that serves Italian food and is kids friendly. It is located in the city centre near Rainbow Vegetarian Café. It has a moderate price range and a customer rating of 1 out of 5.
"name[The Vaults], eatType[pub], food[Italian], priceRange[moderate], customer rating[1 out of 5], area[riverside], familyFriendly[no], near[Rainbow Vegetarian Café]"	Rainbow Vegetarian Café is a pub called The Vaults that serves Italian food and is not kid friendly. It has a moderate price range and a customer rating of 1 out of 5. It is located in the riverside area.
"name[The Vaults], eatType[pub], food[Italian], priceRange[moderate], customer rating[1 out of 5], area[riverside], familyFriendly[yes], near[Rainbow Vegetarian Café]"	The Vaults is a pub that serves Italian food and is kid friendly. It is located in the riverside area near Rainbow Vegetarian Café. It has a moderate price range and a customer rating of 1 out of 5.
"name[The Vaults], eatType[pub], food[Italian], priceRange[moderate], customer rating[3 out of 5], area[city centre], familyFriendly[no], near[Rainbow Vegetarian Café]"	The Vaults is a pub that serves Italian food at a moderate price. It is located in the city centre near Rainbow Vegetarian Café. It is not kid friendly and has a customer rating of 3 out of 5.
"name[The Vaults], eatType[pub], food[Italian], priceRange[moderate], customer rating[3 out of 5], area[city centre], familyFriendly[yes], near[Rainbow Vegetarian Café]"	The Vaults is a pub that serves Italian food and is kid friendly. It is located in the city centre near Rainbow Vegetarian Café. It has a moderate price range and a customer rating of 3 out of 5.
"name[The Vaults], eatType[pub], food[Italian], priceRange[moderate], customer rating[3 out of 5], area[riverside], familyFriendly[no], near[Rainbow Vegetarian Café]"	The Vaults is a moderately priced pub serving Italian food. It is located in the riverside area near Rainbow Vegetarian Café. It is not kid friendly and has a customer rating of 3 out of 5.
"name[The Vaults], eatType[pub], food[Italian], priceRange[moderate], customer rating[3 out of 5], area[riverside], familyFriendly[yes], near[Rainbow Vegetarian Café]"	There is a moderately priced pub called The Vaults that serves Italian food. It is located in riverside near Rainbow Vegetarian Café. It is kid friendly and has a customer rating of 3 out of 5.
"name[The Vaults], eatType[pub], food[Italian], priceRange[more than £30], customer rating[high], area[city centre], familyFriendly[no], near[Rainbow Vegetarian Café]"	The Vaults is a pub that serves Italian food with a price range of more than £30. It is not children friendly and has a high customer rating. It is located in the city centre near Rainbow Vegetarian Café.
"name[The Vaults], eatType[pub], food[Italian], priceRange[more than £30], customer rating[high], area[city centre], familyFriendly[yes], near[Rainbow Vegetarian Café]"	Child friendly The Vaults is a pub that serves Italian food and is located in the city centre near Rainbow Vegetarian Café. It has a high customer rating and a price range of more than £30.
"name[The Vaults], eatType[pub], food[Italian], priceRange[more than £30], customer rating[high], area[riverside], familyFriendly[no], near[Rainbow Vegetarian Café]"	In the riverside area near Rainbow Vegetarian Café is a pub called The Vaults. It serves Italian food and has a high customer rating. It is not children friendly and has a price range of more than £30.
"name[The Vaults], eatType[pub], food[Italian], priceRange[more than £30], customer rating[high], area[riverside], familyFriendly[yes], near[Rainbow Vegetarian Café]"	This pub is located in the riverside area near Rainbow Vegetarian Café.  It is called The Vaults and is child friendly.  It serves Italian food and has a price range of more than £30.
"name[The Vaults], eatType[pub], food[Japanese], priceRange[£20-25], customer rating[3 out of 5], area[city centre], familyFriendly[no], near[Rainbow Vegetarian Café]"	The Vaults is a pub that serves Japanese food in the £20-25 price range with a customer rating of 3 out of 5. It is located in the city centre near Rainbow Vegetarian Café and is not kid friendly.
"name[The Vaults], eatType[pub], food[Japanese], priceRange[£20-25], customer rating[3 out of 5], area[city centre], familyFriendly[yes], near[Rainbow Vegetarian Café]"	The Vaults is a pub that serves Japanese food in the £20-25 price range. It is located in the city centre near Rainbow Vegetarian Café. It is kid friendly and has a customer rating of 3 out of 5.
"name[The Vaults], eatType[pub], food[Japanese], priceRange[£20-25], customer rating[3 out of 5], area[riverside], familyFriendly[no], near[Rainbow Vegetarian Café]"	On the riverside near Rainbow Vegetarian Café is a pub called The Vaults. It serves Japanese food and has a customer rating of 3 out of 5. It is not kid friendly and has a price range of £20-25.
"name[The Vaults], eatType[pub], food[Japanese], priceRange[£20-25], customer rating[3 out of 5], area[riverside], familyFriendly[yes], near[Rainbow Vegetarian Café]"	Rainbow Vegetarian Café is a pub called The Vaults that serves Japanese food and is kid friendly. It has a customer rating of 3 out of 5 and is in the riverside area.
"name[The Vaults], eatType[pub], food[Japanese], priceRange[£20-25], customer rating[high], area[city centre], familyFriendly[no], near[Rainbow Vegetarian Café]"	This pub is not kid friendly and has a high customer rating.  It is called The Vaults and is near Rainbow Vegetarian Café in the city centre.  It serves Japanese food and has a price range of £20-25.
"name[The Vaults], eatType[pub], food[Japanese], priceRange[£20-25], customer rating[high], area[city centre], familyFriendly[yes], near[Rainbow Vegetarian Café]"	The Vaults is a pub that serves Japanese food in the £20-25 price range. It is located in the city centre near Rainbow Vegetarian Café. It is kid friendly and has a high customer rating.
"name[The Vaults], eatType[pub], food[Japanese], priceRange[£20-25], customer rating[high], area[riverside], familyFriendly[no], near[Rainbow Vegetarian Café]"	High rated Japanese pub The Vaults is located in riverside near Rainbow Vegetarian Café. It is not kid friendly and has a price range of £20-25.
"name[The Vaults], eatType[pub], food[Japanese], priceRange[£20-25], customer rating[high], area[riverside], familyFriendly[no], near[Raja Indian Cuisine]"	In the riverside area near Raja Indian Cuisine is a pub called The Vaults. It serves Japanese food and has a high customer rating. It is not kid friendly and has a price range of £20-25.
"name[The Vaults], eatType[pub], food[Japanese], priceRange[£20-25], customer rating[high], area[riverside], familyFriendly[yes], near[Raja Indian Cuisine]"	This pub is located near Raja Indian Cuisine in the riverside area.  It is called The Vaults and is kid friendly.  It serves Japanese food and has a high customer rating.  Prices range from £20-25.
"name[The Vaults], eatType[pub], food[Japanese], priceRange[cheap], customer rating[5 out of 5], area[city centre], familyFriendly[no], near[Raja Indian Cuisine]"	The Vaults is a cheap pub that serves Japanese food. It is located in the city centre near Raja Indian Cuisine. It is not family-friendly and has a customer rating of 5 out of 5.
"name[The Vaults], eatType[pub], food[Japanese], priceRange[cheap], customer rating[5 out of 5], area[city centre], familyFriendly[yes], near[Raja Indian Cuisine]"	There is a cheap pub The Vaults located in the city centre near Raja Indian Cuisine. It serves Japanese food and is family-friendly. It has a customer rating of 5 out of 5.
"name[The Vaults], eatType[pub], food[Japanese], priceRange[cheap], customer rating[5 out of 5], area[riverside], familyFriendly[no], near[Raja Indian Cuisine]"	This pub is located in the riverside area near Raja Indian Cuisine and is called The Vaults. It serves Japanese food and has a customer rating of 5 out of 5. It is cheap and not family-friendly.
"name[The Vaults], eatType[pub], food[Japanese], priceRange[cheap], customer rating[5 out of 5], area[riverside], familyFriendly[yes], near[Raja Indian Cuisine]"	Cheap Japanese food is served at The Vaults pub in the riverside area near Raja Indian Cuisine. It is family friendly and has a customer rating of 5 out of 5.
"name[The Vaults], eatType[pub], food[Japanese], priceRange[high], customer rating[3 out of 5], area[city centre], familyFriendly[no], near[Raja Indian Cuisine]"	A Japanese pub named The Vaults is located in the city centre near Raja Indian Cuisine. It has a high price range and a customer rating of 3 out of 5. It is not children friendly.
"name[The Vaults], eatType[pub], food[Japanese], priceRange[high], customer rating[3 out of 5], area[city centre], familyFriendly[yes], near[Raja Indian Cuisine]"	The Vaults is a children friendly pub serving Japanese food in the high price range with a customer rating of 3 out of 5. It is located in the city centre near Raja Indian Cuisine.
"name[The Vaults], eatType[pub], food[Japanese], priceRange[high], customer rating[3 out of 5], area[riverside], familyFriendly[no], near[Raja Indian Cuisine]"	The Vaults is a pub that serves Japanese food and is located in the riverside area near Raja Indian Cuisine. It has a high price range and a customer rating of 3 out of 5. It is not children friendly.
"name[The Vaults], eatType[pub], food[Japanese], priceRange[high], customer rating[3 out of 5], area[riverside], familyFriendly[yes], near[Raja Indian Cuisine]"	The Vaults is a pub that serves Japanese food and is children friendly. It is in the high price range and has a customer rating of 3 out of 5. It is located in the riverside area near Raja Indian Cuisine.
"name[The Vaults], eatType[pub], food[Japanese], priceRange[less than £20], customer rating[average], area[city centre], familyFriendly[no], near[Raja Indian Cuisine]"	The Vaults is a pub that serves Japanese food for less than £20. It is located in the city centre near Raja Indian Cuisine. It has an average customer rating and is not family-friendly.
"name[The Vaults], eatType[pub], food[Japanese], priceRange[less than £20], customer rating[average], area[city centre], familyFriendly[yes], near[Raja Indian Cuisine]"	"For a family-friendly pub with an average customer rating, The Vaults is a pub that serves Japanese food for less than £20. It is located in the city centre near Raja Indian Cuisine."
"name[The Vaults], eatType[pub], food[Japanese], priceRange[less than £20], customer rating[average], area[riverside], familyFriendly[no], near[Raja Indian Cuisine]"	In the riverside area near Raja Indian Cuisine is a pub called The Vaults. It serves Japanese food and has an average customer rating. It is not family-friendly and has a price range of less than £20.
"name[The Vaults], eatType[pub], food[Japanese], priceRange[less than £20], customer rating[average], area[riverside], familyFriendly[yes], near[Raja Indian Cuisine]"	Family friendly The Vaults is a pub that serves Japanese food and has an average customer rating. It is located in the riverside area near Raja Indian Cuisine.
"name[The Vaults], eatType[pub], food[Japanese], priceRange[less than £20], customer rating[low], area[city centre], familyFriendly[no], near[Raja Indian Cuisine]"	The Vaults is a pub that serves Japanese food for less than £20. It is located in the city centre near Raja Indian Cuisine. It is not family-friendly and has a low customer rating.
"name[The Vaults], eatType[pub], food[Japanese], priceRange[less than £20], customer rating[low], area[city centre], familyFriendly[yes], near[Raja Indian Cuisine]"	"Although it has a low customer rating, The Vaults is a family-friendly pub serving Japanese food for less than £20. It is located in the city centre near Raja Indian Cuisine."
"name[The Vaults], eatType[pub], food[Japanese], priceRange[less than £20], customer rating[low], area[riverside], familyFriendly[no], near[Raja Indian Cuisine]"	In the riverside area near Raja Indian Cuisine is a pub called The Vaults. It serves Japanese food and has a low customer rating. It is not family-friendly and has a price range of less than £20.
"name[The Vaults], eatType[pub], food[Japanese], priceRange[less than £20], customer rating[low], area[riverside], familyFriendly[yes], near[Raja Indian Cuisine]"	Family friendly The Vaults is a pub that serves Japanese food for less than £20. It is located near Raja Indian Cuisine in the riverside area.
"name[The Vaults], eatType[pub], food[Japanese], priceRange[moderate], customer rating[1 out of 5], area[city centre], familyFriendly[no], near[Raja Indian Cuisine]"	A Japanese pub named The Vaults is located in the city centre near Raja Indian Cuisine. It has a moderate price range and a customer rating of 1 out of 5. It is not kid friendly.
"name[The Vaults], eatType[pub], food[Japanese], priceRange[moderate], customer rating[1 out of 5], area[city centre], familyFriendly[yes], near[Raja Indian Cuisine]"	Moderately priced Japanese pub The Vaults is located in the city centre near Raja Indian Cuisine. It is kid friendly and has a customer rating of 1 out of 5.
"name[The Vaults], eatType[restaurant], food[French], priceRange[high], area[riverside], familyFriendly[yes], near[Raja Indian Cuisine]"	Family friendly restaurant The Vaults is located near Raja Indian Cuisine in the riverside area. It serves French food and has a high price range.
"name[The Vaults], eatType[restaurant], food[French], priceRange[less than £20], area[city centre], familyFriendly[no], near[Raja Indian Cuisine]"	A French restaurant named The Vaults is located in the city centre near Raja Indian Cuisine. It is not family-friendly and has a price range of less than £20.
"name[The Vaults], eatType[restaurant], food[French], priceRange[less than £20], area[city centre], familyFriendly[yes], near[Raja Indian Cuisine]"	The Vaults is a family-friendly restaurant that serves French food for less than £20. It is located in the city centre near Raja Indian Cuisine.
"name[The Vaults], eatType[restaurant], food[French], priceRange[less than £20], area[riverside], familyFriendly[no], near[Raja Indian Cuisine]"	The Vaults is a restaurant providing French food in the less than £20 price range. It is located in the riverside. It is near Raja Indian Cuisine.
"name[The Vaults], eatType[restaurant], food[French], priceRange[less than £20], area[riverside], familyFriendly[yes], near[Raja Indian Cuisine]"	There is a family friendly restaurant called The Vaults located near Raja Indian Cuisine in the riverside area. It serves French food for less than £20.
"name[The Vaults], eatType[restaurant], food[French], priceRange[moderate], area[city centre], familyFriendly[no], near[Raja Indian Cuisine]"	A French restaurant named The Vaults is located in the city centre near Raja Indian Cuisine. It is not kid friendly and has a moderate price range.
"name[The Vaults], eatType[restaurant], food[French], priceRange[moderate], area[city centre], familyFriendly[yes], near[Raja Indian Cuisine]"	Family friendly The Vaults restaurant is located in the city centre near Raja Indian Cuisine. It serves French food and has a moderate price range.
"name[The Vaults], eatType[restaurant], food[French], priceRange[moderate], area[riverside], familyFriendly[no], near[Raja Indian Cuisine]"	There is a moderately priced French restaurant called The Vaults located in riverside near Raja Indian Cuisine. It is not kids friendly.
"name[The Vaults], eatType[restaurant], food[French], priceRange[moderate], area[riverside], familyFriendly[yes], near[Raja Indian Cuisine]"	Family friendly restaurant The Vaults is located near Raja Indian Cuisine in the riverside area. It serves French food and has a moderate price range.
"name[The Vaults], eatType[restaurant], food[French], priceRange[more than £30], area[city centre], familyFriendly[no], near[Raja Indian Cuisine]"	A French restaurant named The Vaults is located near Raja Indian Cuisine in the city centre. It is not children friendly and is in the high price range.
"name[The Vaults], eatType[restaurant], food[French], priceRange[more than £30], area[city centre], familyFriendly[yes], near[Raja Indian Cuisine]"	Children friendly The Vaults restaurant is located in the city centre near Raja Indian Cuisine. It is a French restaurant with a price range of more than £30.
"name[The Vaults], eatType[restaurant], food[French], priceRange[more than £30], area[riverside], familyFriendly[no], near[Raja Indian Cuisine]"	By the riverside near Raja Indian Cuisine is a French restaurant called The Vaults. It is not children friendly and has a price range of more than £30.
"name[The Vaults], eatType[restaurant], food[French], priceRange[more than £30], area[riverside], familyFriendly[yes], near[Raja Indian Cuisine]"	There is a children friendly restaurant named The Vaults in the riverside area near Raja Indian Cuisine with a price range of more than £30.
"name[The Vaults], eatType[restaurant], food[Indian], priceRange[£20-25], area[riverside], familyFriendly[yes], near[Raja Indian Cuisine]"	The Vaults is a kid friendly restaurant in the riverside area near Raja Indian Cuisine with a price range of £20-25.
"name[The Vaults], eatType[restaurant], food[Indian], priceRange[cheap], area[riverside], familyFriendly[yes], near[Raja Indian Cuisine]"	"Situated in the riverside area near Raja Indian Cuisine, The Vaults is a family friendly restaurant that serves cheap Indian food."
"name[The Vaults], eatType[restaurant], food[Indian], priceRange[high], area[city centre], familyFriendly[no], near[Raja Indian Cuisine]"	An Indian restaurant named The Vaults is located in the city centre near Raja Indian Cuisine. It is not children friendly and is in the high price range.
"name[The Vaults], eatType[restaurant], food[Indian], priceRange[high], area[city centre], familyFriendly[yes], near[Raja Indian Cuisine]"	There is a high priced Indian restaurant called The Vaults located in the city centre near Raja Indian Cuisine. It is children friendly.
"name[The Waterman], eatType[pub], food[Indian], priceRange[high], area[city centre], familyFriendly[yes], near[Raja Indian Cuisine]"	The Waterman is a pub that serves Indian food in the high price range. It is located in the city centre near Raja Indian Cuisine and is children friendly.
"name[The Waterman], eatType[pub], food[Indian], priceRange[high], area[riverside], familyFriendly[no], near[Raja Indian Cuisine]"	The Waterman is a pub that serves Indian food at a high price range. It is located in the riverside area near Raja Indian Cuisine. It is not children friendly.
"name[The Waterman], eatType[pub], food[Indian], priceRange[high], area[riverside], familyFriendly[yes], near[Raja Indian Cuisine]"	On the riverside near Raja Indian Cuisine is a child friendly pub called The Waterman. It serves Indian food and has a high price range.
"name[The Waterman], eatType[pub], food[Indian], priceRange[less than £20], area[city centre], familyFriendly[no], near[Raja Indian Cuisine]"	"For a pub serving Indian food in the city centre, The Waterman is a non family-friendly place with a price range of less than £20. It is located near Raja Indian Cuisine."
"name[The Waterman], eatType[pub], food[Indian], priceRange[less than £20], area[city centre], familyFriendly[yes], near[Raja Indian Cuisine]"	"Located in the city centre near Raja Indian Cuisine, The Waterman is a family-friendly pub serving Indian food for less than £20."
"name[The Waterman], eatType[pub], food[Indian], priceRange[less than £20], area[riverside], familyFriendly[no], near[Raja Indian Cuisine]"	Riverside has a pub called The Waterman that serves Indian food for less than £20. It is near Raja Indian Cuisine and is not family-friendly.
"name[The Waterman], eatType[pub], food[Indian], priceRange[less than £20], area[riverside], familyFriendly[yes], near[Raja Indian Cuisine]"	Riverside has a family friendly pub near Raja Indian Cuisine called The Waterman which serves Indian food for less than £20.
"name[The Waterman], eatType[pub], food[Indian], priceRange[moderate], area[city centre], familyFriendly[no], near[Raja Indian Cuisine]"	Near Raja Indian Cuisine is a pub called The Waterman. It serves Indian food and is not kid friendly. It is in the city centre and has a moderate price range.
"name[The Waterman], eatType[pub], food[Indian], priceRange[moderate], area[city centre], familyFriendly[yes], near[Raja Indian Cuisine]"	Kid friendly pub The Waterman serves Indian food at a moderate price range. It is located in the city centre near Raja Indian Cuisine.
"name[The Waterman], eatType[pub], food[Indian], priceRange[moderate], area[riverside], familyFriendly[no], near[Raja Indian Cuisine]"	Serving Indian food in the riverside area is a moderately priced pub named The Waterman. It is not kid friendly and is located near Raja Indian Cuisine.
"name[The Waterman], eatType[pub], food[Indian], priceRange[moderate], area[riverside], familyFriendly[yes], near[Raja Indian Cuisine]"	At the riverside near Raja Indian Cuisine is a kids friendly pub called The Waterman which serves Indian food at a moderate price.
"name[The Waterman], eatType[pub], food[Indian], priceRange[more than £30], area[riverside], familyFriendly[yes], near[Raja Indian Cuisine]"	By the riverside near Raja Indian Cuisine is a child friendly pub called The Waterman which serves Indian food and has a price range of more than £30.
"name[The Waterman], eatType[pub], food[Italian], priceRange[£20-25], area[riverside], familyFriendly[yes], near[Raja Indian Cuisine]"	The Waterman is a pub that serves Italian food and is kids friendly. It is located in the riverside area near Raja Indian Cuisine. The price range is £20-25.
"name[The Waterman], eatType[pub], food[Italian], priceRange[cheap], area[riverside], familyFriendly[yes], near[Raja Indian Cuisine]"	The Waterman is a cheap family friendly pub serving Italian food near Raja Indian Cuisine in the riverside area.
"name[The Waterman], eatType[pub], food[Italian], priceRange[high], area[city centre], familyFriendly[no], near[Raja Indian Cuisine]"	Italian pub The Waterman is located in the city centre near Raja Indian Cuisine. It is not children friendly and has a high price range.
"name[The Waterman], eatType[pub], food[Italian], priceRange[high], area[city centre], familyFriendly[yes], near[Raja Indian Cuisine]"	The Watermans is a pub that serves Italian food and is located in the city centre near Raja Indian Cuisine. It is children friendly and has a high price range.
"name[The Waterman], eatType[pub], food[Italian], priceRange[high], area[riverside], familyFriendly[no], near[Raja Indian Cuisine]"	"Located near Raja Indian Cuisine in the riverside area, The Waterman is a pub that serves Italian food. It is not children friendly and has a high price range."
"name[The Waterman], eatType[pub], food[Italian], priceRange[high], area[riverside], familyFriendly[yes], near[Raja Indian Cuisine]"	Riverside has a children friendly pub near Raja Indian Cuisine called The Waterman which serves Italian food and has a high price range.
"name[The Waterman], eatType[pub], food[Italian], priceRange[less than £20], area[city centre], familyFriendly[no], near[Raja Indian Cuisine]"	Near Raja Indian Cuisine in the city centre is a pub called The Waterman. It serves Italian food for less than £20. It is not family-friendly.
"name[The Waterman], eatType[pub], food[Italian], priceRange[less than £20], area[city centre], familyFriendly[yes], near[Raja Indian Cuisine]"	The Waterman is a pub that serves Italian food for less than £20. It is family-friendly and located in the city centre near Raja Indian Cuisine.
"name[The Waterman], eatType[pub], food[Italian], priceRange[less than £20], area[riverside], familyFriendly[no], near[Raja Indian Cuisine]"	By the riverside near Raja Indian Cuisine is a pub called The Waterman. It serves Italian food for less than £20. It is not family-friendly.
"name[The Waterman], eatType[restaurant], food[Indian], priceRange[high], area[city centre], familyFriendly[yes], near[Raja Indian Cuisine]"	The Waterman is a high priced Indian restaurant that is children friendly and is located in the city centre near Raja Indian Cuisine.
"name[The Waterman], eatType[restaurant], food[Indian], priceRange[high], area[riverside], familyFriendly[no], near[Raja Indian Cuisine]"	There is a high priced Indian restaurant called The Waterman in the riverside area near Raja Indian Cuisine. It is not children friendly.
"name[The Waterman], eatType[restaurant], food[Indian], priceRange[high], area[riverside], familyFriendly[yes], near[Raja Indian Cuisine]"	A children friendly restaurant named The Waterman is located in the riverside area near Raja Indian Cuisine. It has a high price range.
"name[The Waterman], eatType[restaurant], food[Indian], priceRange[less than £20], area[city centre], familyFriendly[no], near[Raja Indian Cuisine]"	Indian restaurant The Waterman is located in the city centre near Raja Indian Cuisine. It is not family-friendly and is in the less than £20 price range.
"name[The Waterman], eatType[restaurant], food[Indian], priceRange[less than £20], area[city centre], familyFriendly[yes], near[Raja Indian Cuisine]"	A family-friendly restaurant in the city centre near Raja Indian Cuisine is The Waterman.  It serves Indian food for less than £20.
"name[The Waterman], eatType[restaurant], food[Indian], priceRange[less than £20], area[riverside], familyFriendly[no], near[Raja Indian Cuisine]"	By the riverside near Raja Indian Cuisine is a Indian restaurant called The Waterman. It is not family-friendly and has a price range of less than £20.
"name[The Waterman], eatType[restaurant], food[Indian], priceRange[less than £20], area[riverside], familyFriendly[yes], near[Raja Indian Cuisine]"	The Waterman is a family friendly restaurant that serves Indian food for less than £20. It is located in the riverside area near Raja Indian Cuisine.
"name[The Waterman], eatType[restaurant], food[Indian], priceRange[moderate], area[city centre], familyFriendly[no], near[Raja Indian Cuisine]"	Moderately priced Indian restaurant The Waterman is located in the city centre near Raja Indian Cuisine. It is not kid friendly.
"name[The Waterman], eatType[restaurant], food[Indian], priceRange[moderate], area[city centre], familyFriendly[yes], near[Raja Indian Cuisine]"	Family friendly The Waterman restaurant is located in the city centre near Raja Indian Cuisine. It serves Indian food and has a moderate price range.
"name[The Waterman], eatType[restaurant], food[Indian], priceRange[moderate], area[riverside], familyFriendly[no], near[Raja Indian Cuisine]"	Moderately priced Indian restaurant The Waterman is located in riverside near Raja Indian Cuisine. It is not kid friendly.
"name[The Waterman], eatType[restaurant], food[Indian], priceRange[moderate], area[riverside], familyFriendly[yes], near[Raja Indian Cuisine]"	A kid friendly restaurant named The Waterman is located near Raja Indian Cuisine in the riverside area. It has a moderate price range.
"name[The Waterman], eatType[restaurant], food[Indian], priceRange[more than £30], area[riverside], familyFriendly[yes], near[Raja Indian Cuisine]"	Next to Raja Indian Cuisine is a child friendly restaurant called The Waterman. It serves Indian food and has a price range of more than £30.
"name[The Waterman], eatType[restaurant], food[Italian], priceRange[£20-25], area[riverside], familyFriendly[yes], near[Raja Indian Cuisine]"	Family friendly restaurant The Waterman is located near Raja Indian Cuisine in the riverside area. It serves Italian food and has a price range of £20-25.
"name[The Waterman], eatType[restaurant], food[Italian], priceRange[cheap], area[riverside], familyFriendly[yes], near[Raja Indian Cuisine]"	There is a cheap restaurant The Waterman located in riverside near Raja Indian Cuisine. It is family friendly.
"name[The Waterman], eatType[restaurant], food[Italian], priceRange[high], area[city centre], familyFriendly[no], near[Raja Indian Cuisine]"	"If you are looking for a high priced Italian restaurant in the city centre, try The Waterman. It is not children friendly."
"name[The Waterman], eatType[restaurant], food[Italian], priceRange[high], area[city centre], familyFriendly[yes], near[Raja Indian Cuisine]"	The Waterman is a high priced Italian restaurant that is children friendly and is located in the city centre near Raja Indian Cuisine.
"name[The Waterman], eatType[restaurant], food[Italian], priceRange[high], area[riverside], familyFriendly[no], near[Raja Indian Cuisine]"	There is a high priced Italian restaurant called The Waterman in the riverside area near Raja Indian Cuisine. It is not children friendly.
"name[The Waterman], eatType[restaurant], food[Italian], priceRange[high], area[riverside], familyFriendly[yes], near[Raja Indian Cuisine]"	Children friendly The Waterman restaurant is located in the riverside area near Raja Indian Cuisine. It serves Italian food.
"name[The Waterman], eatType[restaurant], food[Italian], priceRange[less than £20], area[city centre], familyFriendly[no], near[Raja Indian Cuisine]"	Low priced Italian restaurant The Waterman is located in the city centre near Raja Indian Cuisine. It is not family-friendly.
"name[The Waterman], eatType[restaurant], food[Italian], priceRange[less than £20], area[city centre], familyFriendly[yes], near[Raja Indian Cuisine]"	There is a family-friendly restaurant called The Waterman that serves Italian food for less than £20. It is located in the city centre near Raja Indian Cuisine.
"name[The Waterman], eatType[restaurant], food[Italian], priceRange[less than £20], area[riverside], familyFriendly[no], near[Raja Indian Cuisine]"	The Waterman is a restaurant providing Italian food in the less than £20 price range. It is located in the riverside. It is near Raja Indian Cuisine.
"name[The Wrestlers], eatType[pub], food[Italian], priceRange[less than £20], area[riverside], familyFriendly[no], near[Raja Indian Cuisine]"	By the riverside near Raja Indian Cuisine is a pub called The Wrestlers. It serves Italian food for less than £20. It is not family-friendly.
"name[The Wrestlers], eatType[pub], food[Italian], priceRange[less than £20], area[riverside], familyFriendly[yes], near[Raja Indian Cuisine]"	"Situated near Raja Indian Cuisine in the riverside area, The Wrestlers is a family friendly pub that serves Italian food for less than £20."
"name[The Wrestlers], eatType[pub], food[Italian], priceRange[moderate], area[city centre], familyFriendly[no], near[Raja Indian Cuisine]"	Moderately priced Italian pub The Wrestlers is located in the city centre near Raja Indian Cuisine. It is not kid friendly.
"name[The Wrestlers], eatType[pub], food[Italian], priceRange[moderate], area[city centre], familyFriendly[yes], near[Raja Indian Cuisine]"	A pub named The Wrestlers is located in the city centre near Raja Indian Cuisine. It is kid friendly and serves Italian food at a moderate price.
"name[The Wrestlers], eatType[pub], food[Italian], priceRange[moderate], area[riverside], familyFriendly[no], near[Raja Indian Cuisine]"	Moderately priced Italian food is served at The Wrestlers pub near Raja Indian Cuisine in riverside. It is not kid friendly.
"name[The Wrestlers], eatType[pub], food[Italian], priceRange[moderate], area[riverside], familyFriendly[yes], near[Raja Indian Cuisine]"	Children friendly pub The Wrestlers serves Italian food at moderate prices. It is located in the riverside area near Raja Indian Cuisine.
"name[The Wrestlers], eatType[pub], food[Italian], priceRange[more than £30], area[riverside], familyFriendly[yes], near[Raja Indian Cuisine]"	At the riverside near Raja Indian Cuisine is a child friendly pub called The Wrestlers which serves Italian food and has a price range of more than £30.
"name[The Wrestlers], eatType[pub], food[Japanese], priceRange[£20-25], area[riverside], familyFriendly[yes], near[Raja Indian Cuisine]"	A kid friendly pub near Raja Indian Cuisine in the riverside area is The Wrestlers. It serves Japanese food and has a price range of £20-25.
"name[The Wrestlers], eatType[pub], food[Japanese], priceRange[cheap], area[riverside], familyFriendly[yes], near[Raja Indian Cuisine]"	The Wrestlers is a cheap family friendly pub serving Japanese food in the riverside area near Raja Indian Cuisine.
"name[The Wrestlers], eatType[pub], food[Japanese], priceRange[high], area[riverside], familyFriendly[yes], near[Raja Indian Cuisine]"	Riverside has a children friendly pub near Raja Indian Cuisine called The Wrestlers which serves Japanese food and has a high price range.
"name[The Wrestlers], eatType[pub], food[Japanese], priceRange[less than £20], area[city centre], familyFriendly[no], near[Raja Indian Cuisine]"	There is a pub called The Wrestlers that serves Japanese food for less than £20. It is located in the city centre near Raja Indian Cuisine and is not family-friendly.
"name[The Wrestlers], eatType[pub], food[Japanese], priceRange[less than £20], area[city centre], familyFriendly[yes], near[Raja Indian Cuisine]"	"For a family-friendly pub serving Japanese food in the city centre, The Wrestlers is located near Raja Indian Cuisine. It has a price range of less than £20."
"name[The Wrestlers], eatType[pub], food[Japanese], priceRange[less than £20], area[riverside], familyFriendly[no], near[Raja Indian Cuisine]"	For a pub serving Japanese food in the riverside area then try The Wrestlers. It is near Raja Indian Cuisine and is not family-friendly. Prices are less than £20.
"name[The Wrestlers], eatType[pub], food[Japanese], priceRange[less than £20], area[riverside], familyFriendly[yes], near[Raja Indian Cuisine]"	In the riverside area near Raja Indian Cuisine is a family friendly pub called The Wrestlers which serves Japanese food for less than £20.
"name[The Wrestlers], eatType[pub], food[Japanese], priceRange[moderate], area[city centre], familyFriendly[no], near[Raja Indian Cuisine]"	A pub named The Wrestlers is located in the city centre near Raja Indian Cuisine. It serves Japanese food and is moderately priced. It is not kid friendly.
"name[The Wrestlers], eatType[pub], food[Japanese], priceRange[moderate], area[city centre], familyFriendly[yes], near[Raja Indian Cuisine]"	Near Raja Indian Cuisine in the city centre is a kid friendly pub called The Wrestlers which serves Japanese food at a moderate price.
"name[The Wrestlers], eatType[pub], food[Japanese], priceRange[moderate], area[riverside], familyFriendly[no], near[Raja Indian Cuisine]"	"Located near Raja Indian Cuisine in the riverside area, The Wrestlers is a moderately priced pub serving Japanese food. It is not kid friendly."
"name[The Wrestlers], eatType[pub], food[Japanese], priceRange[moderate], area[riverside], familyFriendly[yes], near[Raja Indian Cuisine]"	Children friendly pub The Wrestlers serves Japanese food at moderate prices. It is located in the riverside area near Raja Indian Cuisine.
"name[The Wrestlers], eatType[pub], food[Japanese], priceRange[moderate], customer rating[1 out of 5], area[city centre], familyFriendly[yes], near[Raja Indian Cuisine]"	Moderately priced Japanese pub The Wrestlers is located in the city centre near Raja Indian Cuisine. It is kid friendly and has a customer rating of 1 out of 5.
"name[The Wrestlers], eatType[pub], food[Japanese], priceRange[moderate], customer rating[1 out of 5], area[riverside], familyFriendly[no], near[Raja Indian Cuisine]"	The Wrestlers is a pub that serves Japanese food at a moderate price. It is located in the riverside area near Raja Indian Cuisine. It is not kid friendly and has a customer rating of 1 out of 5.
"name[The Wrestlers], eatType[pub], food[Japanese], priceRange[moderate], customer rating[1 out of 5], area[riverside], familyFriendly[yes], near[Raja Indian Cuisine]"	The Wrestlers is a pub that serves Japanese food and is kid friendly. It is located in the riverside area near Raja Indian Cuisine. It has a moderate price range and a customer rating of 1 out of 5.
"name[The Wrestlers], eatType[pub], food[Japanese], priceRange[more than £30], area[city centre], familyFriendly[no], near[Raja Indian Cuisine]"	In the city centre near Raja Indian Cuisine is a pub called The Wrestlers. It serves Japanese food and is not children friendly. The price range is more than £30.
"name[The Wrestlers], eatType[pub], food[Japanese], priceRange[more than £30], area[city centre], familyFriendly[yes], near[Raja Indian Cuisine]"	The Wrestlers is a children friendly pub serving Japanese food in the city centre near Raja Indian Cuisine. It has a price range of more than £30.
"name[The Wrestlers], eatType[pub], food[Japanese], priceRange[more than £30], area[riverside], familyFriendly[no], near[Raja Indian Cuisine]"	There is a pub called The Wrestlers that serves Japanese food and is not children friendly. It is located in the riverside area near Raja Indian Cuisine. The price range is more than £30.
"name[The Wrestlers], eatType[pub], food[Japanese], priceRange[more than £30], area[riverside], familyFriendly[yes], near[Raja Indian Cuisine]"	Riverside has a pub called The Wrestlers that serves Japanese food and is children friendly. It is near Raja Indian Cuisine and has a price range of more than £30.
"name[The Wrestlers], eatType[pub], food[Japanese], priceRange[more than £30], customer rating[5 out of 5], area[city centre], familyFriendly[no], near[Raja Indian Cuisine]"	In the city centre near Raja Indian Cuisine is a pub called The Wrestlers. It serves Japanese food and has a customer rating of 5 out of 5. It is not children friendly and has a price range of more than £30.
"name[The Wrestlers], eatType[pub], food[Japanese], priceRange[more than £30], customer rating[5 out of 5], area[city centre], familyFriendly[yes], near[Raja Indian Cuisine]"	The Wrestlers is a children friendly pub serving Japanese food with a price range of more than £30 and a customer rating of 5 out of 5. It is located in the city centre near Raja Indian Cuisine.
"name[The Wrestlers], eatType[pub], food[Japanese], priceRange[more than £30], customer rating[5 out of 5], area[riverside], familyFriendly[no], near[Raja Indian Cuisine]"	"This pub is not children friendly and has a price range of more than £30, The Wrestlers is located in the riverside area near Raja Indian Cuisine.  It serves Japanese food and has a customer rating of 5 out of 5."
"name[The Wrestlers], eatType[pub], food[Japanese], priceRange[more than £30], customer rating[5 out of 5], area[riverside], familyFriendly[yes], near[Raja Indian Cuisine]"	Children friendly Japanese pub The Wrestlers is located in riverside near Raja Indian Cuisine. It has a price range of more than £30 and a customer rating of 5 out of 5.
"name[The Wrestlers], eatType[pub], food[Japanese], priceRange[more than £30], customer rating[low], area[city centre], familyFriendly[no], near[Raja Indian Cuisine]"	The Wrestlers is a pub that serves Japanese food in the city centre near Raja Indian Cuisine. It has a low customer rating and a price range of more than £30. It is not children friendly.
"name[The Wrestlers], eatType[pub], food[Japanese], priceRange[more than £30], customer rating[low], area[city centre], familyFriendly[yes], near[Raja Indian Cuisine]"	The Wrestlers is a children friendly pub serving Japanese food in the city centre near Raja Indian Cuisine. It has a low customer rating and a price range of more than £30.
"name[The Wrestlers], eatType[pub], food[Japanese], priceRange[more than £30], customer rating[low], area[riverside], familyFriendly[no], near[Raja Indian Cuisine]"	"Although not child friendly, The Wrestlers is a pub that serves Japanese food and is located in the riverside area near Raja Indian Cuisine. It has a low customer rating and a price range of more than £30."
"name[The Wrestlers], eatType[pub], food[Japanese], priceRange[more than £30], customer rating[low], area[riverside], familyFriendly[yes], near[Raja Indian Cuisine]"	Children friendly Japanese pub The Wrestlers has a low customer rating and a price range of more than £30. It is located in the riverside area near Raja Indian Cuisine.
"name[The Wrestlers], eatType[restaurant], food[Italian], priceRange[less than £20], area[riverside], familyFriendly[no], near[Raja Indian Cuisine]"	At the riverside near Raja Indian Cuisine is a Italian restaurant called The Wrestlers. It is not family-friendly and has a price range of less than £20.
"name[The Wrestlers], eatType[restaurant], food[Italian], priceRange[less than £20], area[riverside], familyFriendly[yes], near[Raja Indian Cuisine]"	There is a family friendly restaurant called The Wrestlers located near Raja Indian Cuisine in the riverside area. It serves Italian food for less than £20.
"name[The Wrestlers], eatType[restaurant], food[Italian], priceRange[moderate], area[city centre], familyFriendly[no], near[Raja Indian Cuisine]"	Moderately priced Italian restaurant The Wrestlers is located in the city centre near Raja Indian Cuisine. It is not kid friendly.
"name[The Wrestlers], eatType[restaurant], food[Italian], priceRange[moderate], area[city centre], familyFriendly[yes], near[Raja Indian Cuisine]"	Moderately priced Italian restaurant The Wrestlers is located in the city centre near Raja Indian Cuisine. It is kid friendly.
"name[The Wrestlers], eatType[restaurant], food[Italian], priceRange[moderate], area[riverside], familyFriendly[no], near[Raja Indian Cuisine]"	Moderately priced Italian restaurant The Wrestlers is located in riverside near Raja Indian Cuisine. It is not kid friendly.
"name[The Wrestlers], eatType[restaurant], food[Italian], priceRange[moderate], area[riverside], familyFriendly[yes], near[Raja Indian Cuisine]"	If you're looking for a kid friendly restaurant that serves Italian food then try The Wrestlers. It is located in the riverside area near Raja Indian Cuisine.
"name[The Wrestlers], eatType[restaurant], food[Italian], priceRange[more than £30], area[riverside], familyFriendly[yes], near[Raja Indian Cuisine]"	By the riverside and near Raja Indian Cuisine is a child friendly restaurant called The Wrestlers. It serves Italian food.
"name[The Wrestlers], eatType[restaurant], food[Japanese], priceRange[£20-25], area[riverside], familyFriendly[yes], near[Raja Indian Cuisine]"	"Situated in the riverside area near Raja Indian Cuisine, The Wrestlers is a kid friendly restaurant with a price range of £20-25."
"name[The Wrestlers], eatType[restaurant], food[Japanese], priceRange[cheap], area[riverside], familyFriendly[yes], near[Raja Indian Cuisine]"	Cheap Japanese food in a family friendly restaurant called The Wrestlers in the riverside area.
"name[The Wrestlers], eatType[restaurant], food[Japanese], priceRange[high], area[riverside], familyFriendly[yes], near[Raja Indian Cuisine]"	Children friendly The Wrestlers restaurant is located in the riverside area near Raja Indian Cuisine. It serves Japanese food.
"name[The Wrestlers], eatType[restaurant], food[Japanese], priceRange[less than £20], area[city centre], familyFriendly[no], near[Raja Indian Cuisine]"	Japanese restaurant The Wrestlers is located in the city centre near Raja Indian Cuisine. It is not family-friendly and is in the less than £20 price range.
"name[The Wrestlers], eatType[restaurant], food[Japanese], priceRange[less than £20], area[city centre], familyFriendly[yes], near[Raja Indian Cuisine]"	The Wrestlers is a family-friendly restaurant that serves Japanese food for less than £20. It is located in the city centre near Raja Indian Cuisine.
"name[The Wrestlers], eatType[restaurant], food[Japanese], priceRange[less than £20], area[riverside], familyFriendly[no], near[Raja Indian Cuisine]"	At the riverside near Raja Indian Cuisine is a Japanese restaurant called The Wrestlers. It is not family-friendly and has a price range of less than £20.
"name[The Wrestlers], eatType[restaurant], food[Japanese], priceRange[less than £20], area[riverside], familyFriendly[yes], near[Raja Indian Cuisine]"	There is a family friendly restaurant called The Wrestlers located near Raja Indian Cuisine in the riverside area. It serves Japanese food for less than £20.
"name[The Wrestlers], eatType[restaurant], food[Japanese], priceRange[moderate], area[city centre], familyFriendly[no], near[Raja Indian Cuisine]"	Moderately priced Japanese restaurant The Wrestlers is located in the city centre near Raja Indian Cuisine. It is not kid friendly.
"name[The Wrestlers], eatType[restaurant], food[Japanese], priceRange[moderate], area[city centre], familyFriendly[yes], near[Raja Indian Cuisine]"	Family friendly The Wrestlers restaurant is located in the city centre near Raja Indian Cuisine. It serves Japanese food and has a moderate price range.
"name[The Wrestlers], eatType[restaurant], food[Japanese], priceRange[moderate], area[riverside], familyFriendly[no], near[Raja Indian Cuisine]"	There is a moderately priced Japanese restaurant called The Wrestlers located in riverside near Raja Indian Cuisine. It is not kids friendly.
"name[The Wrestlers], eatType[restaurant], food[Japanese], priceRange[moderate], area[riverside], familyFriendly[yes], near[Raja Indian Cuisine]"	If you're looking for a kid friendly restaurant that serves Japanese food then try The Wrestlers. It is located in the riverside area near Raja Indian Cuisine.
"name[The Wrestlers], eatType[restaurant], food[Japanese], priceRange[more than £30], area[city centre], familyFriendly[no], near[Raja Indian Cuisine]"	Located in the city centre near Raja Indian Cuisine is a restaurant called The Wrestlers. It is not children friendly and has a price range of more than £30.
"name[The Wrestlers], eatType[restaurant], food[Japanese], priceRange[more than £30], area[city centre], familyFriendly[yes], near[Raja Indian Cuisine]"	Near Raja Indian Cuisine is a child friendly restaurant called The Wrestlers which serves Japanese food and has a price range of more than £30.
"name[The Wrestlers], eatType[restaurant], food[Japanese], priceRange[more than £30], area[riverside], familyFriendly[no], near[Raja Indian Cuisine]"	By the riverside near Raja Indian Cuisine is a Japanese restaurant called The Wrestlers. It is not children friendly and has a price range of more than £30.
"name[The Wrestlers], eatType[restaurant], food[Japanese], priceRange[more than £30], area[riverside], familyFriendly[yes], near[Raja Indian Cuisine]"	Family friendly restaurant The Wrestlers is located near Raja Indian Cuisine in the riverside area. It serves Japanese food and has a price range of more than £30.
"name[Wildwood], eatType[coffee shop], area[riverside]"	There is a coffee shop in the riverside area called Wildwood which has a low customer rating.
"name[Wildwood], eatType[pub], area[riverside]"	At the riverside there is a pub called Wildwood.
"name[Wildwood], eatType[pub], food[French], area[riverside], familyFriendly[yes], near[Raja Indian Cuisine]"	"Located near Raja Indian Cuisine in the riverside area, Wildwood is a child friendly pub that serves French food."
"name[Wildwood], eatType[pub], food[Indian], area[city centre], familyFriendly[no], near[Raja Indian Cuisine]"	An Indian pub near Raja Indian Cuisine in the city centre is Wildwood. It is not family-friendly.
"name[Wildwood], eatType[pub], food[Indian], area[city centre], familyFriendly[yes], near[Raja Indian Cuisine]"	"For a family-friendly pub serving Indian food in the city centre, Wildwood is located near Raja Indian Cuisine."
"name[Wildwood], eatType[pub], food[Indian], area[riverside], familyFriendly[no], near[Raja Indian Cuisine]"	By the riverside near Raja Indian Cuisine is a pub called Wildwood. It serves Indian food and is not family-friendly.
"name[Wildwood], eatType[pub], food[Indian], area[riverside], familyFriendly[yes], near[Raja Indian Cuisine]"	At the riverside near Raja Indian Cuisine is a child friendly pub called Wildwood that serves Indian food.
"name[Wildwood], eatType[pub], food[Italian], area[city centre], familyFriendly[no], near[Raja Indian Cuisine]"	The Wildwood is a pub that serves Italian food in the city centre near Raja Indian Cuisine. It is not family-friendly.
"name[Wildwood], eatType[pub], food[Italian], area[city centre], familyFriendly[yes], near[Raja Indian Cuisine]"	There is a pub called Wildwood that serves Italian food in the city centre near Raja Indian Cuisine. It is family-friendly.
"name[Wildwood], eatType[pub], food[Italian], area[riverside], familyFriendly[no], near[Raja Indian Cuisine]"	The Wildwood is a pub that serves Italian food near Raja Indian Cuisine in the riverside area. It is not family-friendly.
"name[Wildwood], eatType[pub], food[Italian], area[riverside], familyFriendly[yes], near[Raja Indian Cuisine]"	By the riverside near Raja Indian Cuisine is a pub called Wildwood. It serves Italian food and is children friendly.
"name[Wildwood], eatType[restaurant], food[French], area[riverside], familyFriendly[yes], near[Raja Indian Cuisine]"	"If you are looking for a family friendly restaurant that serves French food in the riverside area, try Wildwood. It is located near Raja Indian Cuisine."
"name[Wildwood], eatType[restaurant], food[Indian], area[city centre], familyFriendly[no], near[Raja Indian Cuisine]"	The Wildwood is a restaurant that serves Indian food in the city centre near Raja Indian Cuisine. It is not family-friendly.
"name[Wildwood], eatType[restaurant], food[Indian], area[city centre], familyFriendly[yes], near[Raja Indian Cuisine]"	"Situated in the city centre near Raja Indian Cuisine, Wildwood is a family friendly restaurant serving Indian food."
"name[Wildwood], eatType[restaurant], food[Indian], area[riverside], familyFriendly[no], near[Raja Indian Cuisine]"	"Serving Indian food, Wildwood is a restaurant in the riverside area near Raja Indian Cuisine. It is not family-friendly."
"name[Wildwood], eatType[restaurant], food[Indian], area[riverside], familyFriendly[yes], near[Raja Indian Cuisine]"	"If you are looking for a family friendly restaurant that serves Indian food in the riverside area, try Wildwood. It is located near Raja Indian Cuisine."
"name[Wildwood], eatType[restaurant], food[Italian], area[city centre], familyFriendly[no], near[Raja Indian Cuisine]"	An Italian restaurant named Wildwood is located in the city centre near Raja Indian Cuisine. It is not family-friendly.
"name[Wildwood], eatType[restaurant], food[Italian], area[city centre], familyFriendly[yes], near[Raja Indian Cuisine]"	Raja Indian Cuisine is a family-friendly restaurant called Wildwood that serves Italian food and is located in the city centre.
"name[Wildwood], eatType[restaurant], food[Italian], area[riverside], familyFriendly[no], near[Raja Indian Cuisine]"	"Situated in the riverside area near Raja Indian Cuisine, Wildwood is a Italian restaurant that is not family-friendly."
"name[Wildwood], eatType[restaurant], food[Italian], area[riverside], familyFriendly[yes], near[Raja Indian Cuisine]"	The Wildwood is a restaurant that serves Italian food and is kid friendly. It is located in the riverside area near Raja Indian Cuisine.
"name[Zizzi], eatType[coffee shop], area[riverside]"	On the riverside there is a coffee shop called Zizzi with a customer rating of 3 out of 5.
"name[Zizzi], eatType[coffee shop], customer rating[average], near[Burger King]"	There is a coffee shop near Burger King called Zizzi. It has an average customer rating.
"name[Zizzi], eatType[coffee shop], customer rating[high], near[Burger King]"	Coffee shop Zizzi is located near Burger King. It has a high customer rating.
"name[Zizzi], eatType[coffee shop], near[The Sorrento]"	There is a coffee shop near The Sorrento called Zizzi that has a customer rating of 5 out of 5.
"name[Zizzi], eatType[pub], area[riverside]"	Along the riverside is a pub called Zizzi.
"name[Zizzi], eatType[pub], customer rating[average], near[Burger King]"	The Zizzi is a pub near Burger King with an average customer rating.
"name[Zizzi], eatType[pub], customer rating[high], near[Burger King]"	The Zizzi is a pub near Burger King with a high customer rating.
"name[Zizzi], eatType[pub], near[The Sorrento]"	Next to The Sorrento is a pub called Zizzi.
