"name[Blue Spice], eatType[coffee shop], area[city centre]"	The Blue Spice is a coffee shop in the city centre that is not family-friendly.
"name[Blue Spice], eatType[coffee shop], area[riverside]"	For a cheap restaurant in the riverside area then to to Blue Spice.
"name[Blue Spice], eatType[coffee shop], customer rating[5 out of 5], near[Crowne Plaza Hotel]"	A coffee shop near Crowne Plaza Hotel is Blue Spice. It has a customer rating of 5 out of 5.
"name[Blue Spice], eatType[coffee shop], customer rating[average], near[Burger King]"	A coffee shop near Burger King is Blue Spice. It has an average customer rating.
"name[Blue Spice], eatType[coffee shop], customer rating[average], near[Crowne Plaza Hotel]"	"Located near Crowne Plaza Hotel, Blue Spice is a coffee shop with an average customer rating."
"name[Blue Spice], eatType[pub], area[city centre]"	If you are looking for a pub called Blue Spice in the city centre.
"name[Blue Spice], eatType[pub], area[riverside]"	A pub named Blue Spice is located in the riverside area.
"name[Blue Spice], eatType[pub], customer rating[5 out of 5], near[Crowne Plaza Hotel]"	The Blue Spice is a pub near Crowne Plaza Hotel with a customer rating of 5 out of 5.
"name[Blue Spice], eatType[pub], customer rating[average], near[Burger King]"	Near Burger King is a pub called Blue Spice. It has an average customer rating.
"name[Blue Spice], eatType[pub], customer rating[average], near[Crowne Plaza Hotel]"	The Blue Spice is a pub near Crowne Plaza Hotel with an average customer rating.
"name[Blue Spice], eatType[pub], food[Chinese], area[city centre], familyFriendly[no], near[Rainbow Vegetarian Café]"	Near Rainbow Vegetarian Café in the city centre is a pub called Blue Spice. It serves Chinese food and is not family-friendly.
"name[Blue Spice], eatType[pub], food[Chinese], area[city centre], familyFriendly[yes], near[Rainbow Vegetarian Café]"	If you are looking for a family-friendly pub that serves Chinese food in the city centre near Rainbow Vegetarian Café is Blue Spice.
"name[Blue Spice], eatType[pub], food[Chinese], area[riverside], familyFriendly[no], near[Rainbow Vegetarian Café]"	There is a pub called Blue Spice that serves Chinese food in the riverside area near Rainbow Vegetarian Café. It is not family-friendly.
"name[Blue Spice], eatType[pub], food[Chinese], area[riverside], familyFriendly[yes], near[Rainbow Vegetarian Café]"	There is a pub called Blue Spice that serves Chinese food in the riverside area near Rainbow Vegetarian Café. It is family friendly.
"name[Blue Spice], eatType[pub], food[English], area[city centre], familyFriendly[no], near[Rainbow Vegetarian Café]"	"Located in the city centre near Rainbow Vegetarian Café, Blue Spice is a pub that serves English food. It is not family-friendly."
"name[Blue Spice], eatType[pub], food[English], area[city centre], familyFriendly[yes], near[Rainbow Vegetarian Café]"	If you are looking for a family-friendly pub that serves English food in the city centre near Rainbow Vegetarian Café is Blue Spice.
"name[Blue Spice], eatType[pub], food[English], area[riverside], familyFriendly[no], near[Rainbow Vegetarian Café]"	Near Rainbow Vegetarian Café in the riverside area is a pub called Blue Spice. It serves English food and is not family-friendly.
"name[Blue Spice], eatType[pub], food[English], area[riverside], familyFriendly[yes], near[Rainbow Vegetarian Café]"	If you are looking for a family friendly pub that serves English food in the riverside area near Rainbow Vegetarian Café is Blue Spice.
"name[Blue Spice], eatType[restaurant], food[Chinese], area[city centre], familyFriendly[no], near[Rainbow Vegetarian Café]"	Blue Spice is a restaurant that serves Chinese food. It is located in the city centre near Rainbow Vegetarian Café. It is not family-friendly.
"name[Blue Spice], eatType[restaurant], food[Chinese], area[city centre], familyFriendly[yes], near[Rainbow Vegetarian Café]"	If you are looking for a family-friendly restaurant that serves Chinese food in the city centre near Rainbow Vegetarian Café is Blue Spice.
"name[Blue Spice], eatType[restaurant], food[Chinese], area[riverside], familyFriendly[no], near[Rainbow Vegetarian Café]"	Blue Spice is a restaurant that serves Chinese food in the riverside area near Rainbow Vegetarian Café. It is not family-friendly.
"name[Blue Spice], eatType[restaurant], food[Chinese], area[riverside], familyFriendly[yes], near[Rainbow Vegetarian Café]"	There is a restaurant called Blue Spice that serves Chinese food and is located in the riverside area near Rainbow Vegetarian Café.
"name[Blue Spice], eatType[restaurant], food[English], area[city centre], familyFriendly[no], near[Rainbow Vegetarian Café]"	An English restaurant near Rainbow Vegetarian Café in the city centre is Blue Spice. It is not family-friendly.
"name[Blue Spice], eatType[restaurant], food[English], area[city centre], familyFriendly[yes], near[Rainbow Vegetarian Café]"	In the city centre near Rainbow Vegetarian Café is a family friendly restaurant called Blue Spice.
"name[Blue Spice], eatType[restaurant], food[English], area[riverside], familyFriendly[no], near[Rainbow Vegetarian Café]"	Blue Spice is a restaurant that serves English food in the riverside area near Rainbow Vegetarian Café. It is not family-friendly.
"name[Blue Spice], eatType[restaurant], food[English], area[riverside], familyFriendly[yes], near[Rainbow Vegetarian Café]"	Blue Spice is a restaurant that serves English food in the riverside area near Rainbow Vegetarian Café. It is family friendly.
"name[Clowns], eatType[coffee shop], customer rating[3 out of 5], near[All Bar One]"	A coffee shop near All Bar One is Clowns. It has a customer rating of 3 out of 5.
"name[Clowns], eatType[coffee shop], customer rating[5 out of 5], near[Crowne Plaza Hotel]"	If you are looking for a coffee shop near Crowne Plaza Hotel then the Clowns is a 5 out of 5 rated restaurant.
"name[Clowns], eatType[coffee shop], near[The Sorrento]"	There is a coffee shop near The Sorrento called Clowns. It is located near the riverside.
"name[Clowns], eatType[pub], customer rating[3 out of 5], near[All Bar One]"	If you are looking for a pub near All Bar One then you can get Clowns. It has a customer rating of 3 out of 5.
"name[Clowns], eatType[pub], customer rating[5 out of 5], near[Crowne Plaza Hotel]"	Near Crowne Plaza Hotel is a pub called Clowns with a customer rating of 5 out of 5.
"name[Clowns], eatType[pub], near[The Sorrento]"	If you are looking for a pub near The Sorrento then you can get Clowns.
"name[Cocum], eatType[coffee shop], customer rating[high], near[Burger King]"	If you are looking for a coffee shop near Burger King then the Cocum is a highly rated restaurant.
"name[Cocum], eatType[coffee shop], customer rating[high], near[Café Sicilia]"	If you are looking for a coffee shop near Café Sicilia then the Cocum is a highly rated restaurant.
"name[Cocum], eatType[coffee shop], customer rating[low], near[Café Sicilia]"	The Cocum is a coffee shop near Café Sicilia with a low customer rating.
"name[Cocum], eatType[coffee shop], customer rating[low], near[Express by Holiday Inn]"	The Cocum is a coffee shop near Express by Holiday Inn with a low customer rating.
"name[Cocum], eatType[coffee shop], near[The Rice Boat]"	Near The Rice Boat is a coffee shop called Cocum.
"name[Cocum], eatType[coffee shop], near[The Sorrento]"	Near The Sorrento is a coffee shop called Cocum.
"name[Cocum], eatType[pub], customer rating[high], near[Burger King]"	A pub near Burger King is Cocum. It has a high customer rating.
"name[Cocum], eatType[pub], customer rating[high], near[Café Sicilia]"	If you are looking for a pub near Café Sicilia then you can get Cocum. It has a high customer rating.
"name[Cocum], eatType[pub], customer rating[low], near[Café Sicilia]"	A pub near Café Sicilia is Cocum. It has a low customer rating.
"name[Cocum], eatType[pub], customer rating[low], near[Express by Holiday Inn]"	If you are looking for a pub near Express by Holiday Inn then you can get Cocum. It has a low customer rating.
"name[Cocum], eatType[pub], near[The Rice Boat]"	The Cocum is a pub near The Rice Boat.
"name[Cocum], eatType[pub], near[The Sorrento]"	The Cocum is a pub near The Sorrento.
"name[Cotto], eatType[coffee shop], near[The Bakers]"	There is a coffee shop near The Bakers called Cotto. It is located near the riverside.
"name[Cotto], eatType[pub], near[The Bakers]"	The Cotto is a pub near The Bakers.
"name[Giraffe], eatType[coffee shop], near[The Bakers]"	For a cheap coffee shop near The Bakers is Giraffe.
"name[Giraffe], eatType[coffee shop], near[The Rice Boat]"	If you are looking for a coffee shop near The Rice Boat in the city centre there is Giraffe. It is a family friendly place to eat you can eat for less than £20.
"name[Giraffe], eatType[pub], food[English], area[riverside], familyFriendly[yes], near[Rainbow Vegetarian Café]"	There is a pub called Giraffe that serves English food in the riverside area near Rainbow Vegetarian Café. It is family friendly.
"name[Giraffe], eatType[pub], food[Fast food], area[city centre], familyFriendly[no], near[Rainbow Vegetarian Café]"	The Giraffe is a pub that serves Fast food near Rainbow Vegetarian Café in the city centre. It is not family-friendly.
"name[Giraffe], eatType[pub], food[Fast food], area[city centre], familyFriendly[yes], near[Rainbow Vegetarian Café]"	"Located in the city centre near Rainbow Vegetarian Café, Giraffe is a family friendly pub serving Fast food."
"name[Giraffe], eatType[pub], food[Fast food], area[riverside], familyFriendly[no], near[Rainbow Vegetarian Café]"	Near Rainbow Vegetarian Café in the riverside area is a pub called Giraffe. It serves Fast food and is not family-friendly.
"name[Giraffe], eatType[pub], food[Fast food], area[riverside], familyFriendly[yes], near[Rainbow Vegetarian Café]"	The Giraffe is a family friendly pub serving Fast food near Rainbow Vegetarian Café in the riverside area.
"name[Giraffe], eatType[pub], food[Fast food], area[riverside], familyFriendly[yes], near[Raja Indian Cuisine]"	If you are looking for a family friendly pub that serves Fast food in the riverside area near Raja Indian Cuisine is Giraffe.
"name[Giraffe], eatType[pub], food[French], area[city centre], familyFriendly[no], near[Raja Indian Cuisine]"	A French pub near Raja Indian Cuisine in the city centre is Giraffe. It is not family-friendly.
"name[Giraffe], eatType[pub], food[French], area[city centre], familyFriendly[yes], near[Raja Indian Cuisine]"	Giraffe is a family-friendly pub serving French food near Raja Indian Cuisine in the city centre.
"name[Giraffe], eatType[pub], food[French], area[riverside], familyFriendly[no], near[Raja Indian Cuisine]"	In the riverside area near Raja Indian Cuisine is a pub called Giraffe that serves French food. It is not family-friendly.
"name[Giraffe], eatType[pub], food[French], area[riverside], familyFriendly[yes], near[Raja Indian Cuisine]"	"Located near Raja Indian Cuisine in the riverside area, Giraffe is a family friendly pub serving French food."
"name[Giraffe], eatType[pub], near[The Bakers]"	The Giraffe is a pub near The Bakers.
"name[Giraffe], eatType[pub], near[The Rice Boat]"	Near The Rice Boat is a pub called Giraffe.
"name[Giraffe], eatType[restaurant], food[English], area[riverside], familyFriendly[yes], near[Rainbow Vegetarian Café]"	Giraffe is a restaurant that serves English food and is kid friendly. It is located in the riverside area near Rainbow Vegetarian Café.
"name[Giraffe], eatType[restaurant], food[Fast food], area[city centre], familyFriendly[no], near[Rainbow Vegetarian Café]"	There is a restaurant Giraffe located in the city centre near Rainbow Vegetarian Café. It serves Fast food and is not family-friendly.
"name[Giraffe], eatType[restaurant], food[Fast food], area[city centre], familyFriendly[yes], near[Rainbow Vegetarian Café]"	"Located in the city centre near Rainbow Vegetarian Café, Giraffe is a family friendly restaurant that serves Fast food."
"name[Giraffe], eatType[restaurant], food[Fast food], area[riverside], familyFriendly[no], near[Rainbow Vegetarian Café]"	Giraffe is a restaurant that serves Fast food in the riverside area near Rainbow Vegetarian Café. It is not family-friendly.
"name[Giraffe], eatType[restaurant], food[Fast food], area[riverside], familyFriendly[yes], near[Rainbow Vegetarian Café]"	Giraffe is a restaurant that serves Fast food and is kid friendly. It is located in the riverside area near Rainbow Vegetarian Café.
"name[Giraffe], eatType[restaurant], food[Fast food], area[riverside], familyFriendly[yes], near[Raja Indian Cuisine]"	Giraffe is a restaurant that serves Fast food and is kid friendly. It is located in the riverside area near Raja Indian Cuisine.
"name[Giraffe], eatType[restaurant], food[French], area[city centre], familyFriendly[no], near[Raja Indian Cuisine]"	A French restaurant near Raja Indian Cuisine in the city centre is Giraffe. It is not family-friendly.
"name[Giraffe], eatType[restaurant], food[French], area[city centre], familyFriendly[yes], near[Raja Indian Cuisine]"	If you are looking for a family-friendly restaurant that serves French food in the city centre near Raja Indian Cuisine is Giraffe.
"name[Giraffe], eatType[restaurant], food[French], area[riverside], familyFriendly[no], near[Raja Indian Cuisine]"	Giraffe is a restaurant that serves French food in the riverside area near Raja Indian Cuisine. It is not family-friendly.
"name[Giraffe], eatType[restaurant], food[French], area[riverside], familyFriendly[yes], near[Raja Indian Cuisine]"	There is a restaurant called Giraffe that serves French food and is located in the riverside area near Raja Indian Cuisine.
"name[Green Man], eatType[coffee shop], customer rating[1 out of 5], near[All Bar One]"	"With a customer rating of 1 out of 5, Green Man is a coffee shop near All Bar One."
"name[Green Man], eatType[coffee shop], customer rating[3 out of 5], near[All Bar One]"	The Green Man is a coffee shop near All Bar One with a customer rating of 3 out of 5.
"name[Green Man], eatType[pub], customer rating[1 out of 5], near[All Bar One]"	Near All Bar One is a pub called Green Man with a customer rating of 1 out of 5.
"name[Green Man], eatType[pub], customer rating[3 out of 5], near[All Bar One]"	"Located near All Bar One, Green Man is a pub with a customer rating of 3 out of 5."
"name[Green Man], eatType[pub], food[Italian], area[riverside], familyFriendly[yes], near[Express by Holiday Inn]"	If you are looking for a family friendly pub that serves Italian food in the riverside area near Express by Holiday Inn is Green Man.
"name[Green Man], eatType[pub], food[Italian], area[riverside], familyFriendly[yes], near[Raja Indian Cuisine]"	The Green Man is a family friendly pub serving Italian food near Raja Indian Cuisine in the riverside area.
"name[Green Man], eatType[pub], food[Japanese], area[city centre], familyFriendly[no], near[Express by Holiday Inn]"	Near Express by Holiday Inn in the city centre is a pub called Green Man. It serves Japanese food and is not family-friendly.
"name[Green Man], eatType[pub], food[Japanese], area[city centre], familyFriendly[yes], near[Express by Holiday Inn]"	If you are looking for a family-friendly pub that serves Japanese food in the city centre near Express by Holiday Inn is Green Man.
"name[Green Man], eatType[pub], food[Japanese], area[riverside], familyFriendly[no], near[Express by Holiday Inn]"	There is a pub called Green Man that serves Japanese food in the riverside area near Express by Holiday Inn. It is not family-friendly.
"name[Green Man], eatType[pub], food[Japanese], area[riverside], familyFriendly[yes], near[Express by Holiday Inn]"	"Located near Express by Holiday Inn in the riverside area, Green Man is a family friendly pub serving Japanese food."
"name[Green Man], eatType[restaurant], food[Italian], area[riverside], familyFriendly[yes], near[Express by Holiday Inn]"	If you are looking for a family friendly restaurant that serves Italian food in the riverside area near Express by Holiday Inn is Green Man.
"name[Green Man], eatType[restaurant], food[Italian], area[riverside], familyFriendly[yes], near[Raja Indian Cuisine]"	There is a restaurant called Green Man that serves Italian food and is located in the riverside area near Raja Indian Cuisine.
"name[Green Man], eatType[restaurant], food[Japanese], area[city centre], familyFriendly[no], near[Express by Holiday Inn]"	A Japanese restaurant near Express by Holiday Inn in the city centre is Green Man. It is not family-friendly.
"name[Green Man], eatType[restaurant], food[Japanese], area[city centre], familyFriendly[yes], near[Express by Holiday Inn]"	For a family friendly restaurant that serves Japanese food in the city centre near Express by Holiday Inn is Green Man.
"name[Green Man], eatType[restaurant], food[Japanese], area[riverside], familyFriendly[no], near[Express by Holiday Inn]"	The Green Man is a restaurant that serves Japanese food in the riverside area near Express by Holiday Inn. It is not family-friendly.
"name[Green Man], eatType[restaurant], food[Japanese], area[riverside], familyFriendly[yes], near[Express by Holiday Inn]"	There is a restaurant called Green Man that serves Japanese food and is located in the riverside area near Express by Holiday Inn.
"name[Loch Fyne], eatType[coffee shop], area[riverside]"	For a cheap restaurant in the riverside area then to to Loch Fyne.
"name[Loch Fyne], eatType[pub], area[riverside]"	A pub named Loch Fyne is located in the riverside area.
"name[Strada], eatType[coffee shop], area[city centre]"	The Strada is a coffee shop in the city centre that is not family-friendly.
"name[Strada], eatType[coffee shop], customer rating[1 out of 5], near[All Bar One]"	Near All Bar One is a coffee shop called Strada. It has a customer rating of 1 out of 5.
"name[Strada], eatType[coffee shop], customer rating[1 out of 5], near[Rainbow Vegetarian Café]"	"With a customer rating of 1 out of 5, Strada is a coffee shop near Rainbow Vegetarian Café."
"name[Strada], eatType[coffee shop], customer rating[low], near[Express by Holiday Inn]"	A coffee shop near Express by Holiday Inn is Strada. It has a low customer rating.
"name[Strada], eatType[pub], area[city centre]"	If you are looking for a pub called Strada in the city centre.
"name[Strada], eatType[pub], customer rating[1 out of 5], near[All Bar One]"	A pub near All Bar One is Strada. It has a customer rating of 1 out of 5.
"name[Strada], eatType[pub], customer rating[1 out of 5], near[Rainbow Vegetarian Café]"	A pub near Rainbow Vegetarian Café is Strada. It has a customer rating of 1 out of 5.
"name[Strada], eatType[pub], customer rating[low], near[Express by Holiday Inn]"	A pub near Express by Holiday Inn is Strada. It has a low customer rating.
"name[The Cricketers], eatType[coffee shop], customer rating[1 out of 5], familyFriendly[yes], near[Avalon]"	If you are looking for a coffee shop near Avalon then you can get The Cricketers. It is kid friendly and has a customer rating of 1 out of 5.
"name[The Cricketers], eatType[coffee shop], customer rating[3 out of 5], familyFriendly[yes], near[Avalon]"	If you are looking for a kid friendly coffee shop near Avalon is The Cricketers. It has a customer rating of 3 out of 5.
"name[The Cricketers], eatType[coffee shop], customer rating[3 out of 5], familyFriendly[yes], near[Crowne Plaza Hotel]"	A child friendly coffee shop near Crowne Plaza Hotel is The Cricketers. It has a customer rating of 3 out of 5.
"name[The Cricketers], eatType[coffee shop], customer rating[5 out of 5], familyFriendly[no], near[Crowne Plaza Hotel]"	"Near Crowne Plaza Hotel, there is a coffee shop called The Cricketers. It is not family-friendly and has a customer rating of 5 out of 5."
"name[The Cricketers], eatType[coffee shop], customer rating[5 out of 5], familyFriendly[yes], near[Crowne Plaza Hotel]"	The Cricketers is a coffee shop near Crowne Plaza Hotel. It is family friendly and has a customer rating of 5 out of 5.
"name[The Cricketers], eatType[coffee shop], customer rating[average], familyFriendly[no], near[Café Sicilia]"	The Cricketers is a coffee shop near Café Sicilia with an average customer rating. It is not family-friendly.
"name[The Cricketers], eatType[coffee shop], customer rating[average], familyFriendly[no], near[Crowne Plaza Hotel]"	"With an average customer rating, The Cricketers is a coffee shop near Crowne Plaza Hotel. It is not family-friendly."
"name[The Cricketers], eatType[coffee shop], customer rating[average], familyFriendly[yes], near[Café Sicilia]"	A children friendly coffee shop near Café Sicilia is The Cricketers. It has an average customer rating.
"name[The Cricketers], eatType[coffee shop], customer rating[high], familyFriendly[yes], near[Café Sicilia]"	A child friendly coffee shop near Café Sicilia is The Cricketers. It has a high customer rating.
"name[The Cricketers], eatType[coffee shop], customer rating[high], familyFriendly[yes], near[Express by Holiday Inn]"	The Cricketers is a coffee shop near Express by Holiday Inn. It is kid friendly and has a high customer rating.
"name[The Cricketers], eatType[coffee shop], customer rating[low], familyFriendly[no], near[Express by Holiday Inn]"	"Near Express by Holiday Inn, there is a coffee shop called The Cricketers. It is not family-friendly and has a low customer rating."
"name[The Cricketers], eatType[coffee shop], customer rating[low], familyFriendly[no], near[Ranch]"	"Located near Ranch, The Cricketers is a coffee shop with a low customer rating. It is not family-friendly."
"name[The Cricketers], eatType[coffee shop], customer rating[low], familyFriendly[yes], near[Ranch]"	If you are looking for a family friendly coffee shop near Ranch is The Cricketers. It has a low customer rating.
"name[The Cricketers], eatType[restaurant], customer rating[1 out of 5], familyFriendly[yes], near[Avalon]"	A restaurant named The Cricketers is located near Avalon. It is kid friendly and has a customer rating of 1 out of 5.
"name[The Cricketers], eatType[restaurant], customer rating[3 out of 5], familyFriendly[yes], near[Avalon]"	The Cricketers is a kid friendly restaurant near Avalon. It has a customer rating of 3 out of 5.
"name[The Cricketers], eatType[restaurant], customer rating[3 out of 5], familyFriendly[yes], near[Crowne Plaza Hotel]"	A restaurant near Crowne Plaza Hotel is The Cricketers. It is kid friendly and has a customer rating of 3 out of 5.
"name[The Cricketers], eatType[restaurant], customer rating[5 out of 5], familyFriendly[no], near[Crowne Plaza Hotel]"	A restaurant near Crowne Plaza Hotel is The Cricketers. It has a customer rating of 5 out of 5 and is not family-friendly.
"name[The Cricketers], eatType[restaurant], customer rating[5 out of 5], familyFriendly[yes], near[Crowne Plaza Hotel]"	Near Crowne Plaza Hotel is a family friendly restaurant called The Cricketers.
"name[The Cricketers], eatType[restaurant], customer rating[average], familyFriendly[no], near[Café Sicilia]"	"Near Café Sicilia, there is a restaurant called The Cricketers. It has an average customer rating and is not family-friendly."
"name[The Cricketers], eatType[restaurant], customer rating[average], familyFriendly[no], near[Crowne Plaza Hotel]"	The Cricketers is a restaurant near Crowne Plaza Hotel with an average customer rating. It is not family-friendly.
"name[The Cricketers], eatType[restaurant], customer rating[average], familyFriendly[yes], near[Café Sicilia]"	A restaurant named The Cricketers is located near Café Sicilia. It has an average customer rating and is family friendly.
"name[The Cricketers], eatType[restaurant], customer rating[high], familyFriendly[yes], near[Café Sicilia]"	The Cricketers is a restaurant near Café Sicilia with a high customer rating.
"name[The Cricketers], eatType[restaurant], customer rating[high], familyFriendly[yes], near[Express by Holiday Inn]"	If you are looking for a kid friendly restaurant near Express by Holiday Inn is The Cricketers.
"name[The Cricketers], eatType[restaurant], customer rating[low], familyFriendly[no], near[Express by Holiday Inn]"	The Cricketers is a restaurant near Express by Holiday Inn with a low customer rating.
"name[The Cricketers], eatType[restaurant], customer rating[low], familyFriendly[no], near[Ranch]"	"Near Ranch, there is a restaurant called The Cricketers. It has a low customer rating and is not family-friendly."
"name[The Cricketers], eatType[restaurant], customer rating[low], familyFriendly[yes], near[Ranch]"	The Cricketers is a family friendly restaurant near Ranch. It has a low customer rating.
"name[The Cricketers], eatType[restaurant], food[Chinese], priceRange[£20-25], customer rating[high], area[city centre], familyFriendly[no], near[All Bar One]"	In the city centre near All Bar One is a Chinese restaurant called The Cricketers. It has a high customer rating and a price range of £20-25.
"name[The Cricketers], eatType[restaurant], food[Chinese], priceRange[£20-25], customer rating[high], area[city centre], familyFriendly[yes], near[All Bar One]"	This restaurant The Cricketers is a family friendly Chinese restaurant with a high customer rating and a price range of £20-25. It is located in the city centre near All Bar One.
"name[The Cricketers], eatType[restaurant], food[Chinese], priceRange[£20-25], customer rating[high], area[riverside], familyFriendly[no], near[All Bar One]"	Next to the river is a restaurant called The Cricketers that serves Chinese food with a price range of £20-25. It is not child friendly and has a high customer rating.
"name[The Cricketers], eatType[restaurant], food[Chinese], priceRange[£20-25], customer rating[high], area[riverside], familyFriendly[yes], near[All Bar One]"	If you are looking for a kid friendly restaurant that serves Chinese food in the riverside area near All Bar One is The Cricketers. It has a high customer rating and a price range of £20-25.
"name[The Cricketers], eatType[restaurant], food[Chinese], priceRange[cheap], customer rating[5 out of 5], area[city centre], familyFriendly[no], near[All Bar One]"	"Located in the city centre near All Bar One, The Cricketers is a cheap Chinese restaurant with a customer rating of 5 out of 5."
"name[The Cricketers], eatType[restaurant], food[Chinese], priceRange[cheap], customer rating[5 out of 5], area[city centre], familyFriendly[yes], near[All Bar One]"	The Cricketers is a cheap Chinese restaurant located in the city centre near All Bar One. It is family friendly and has a customer rating of 5 out of 5.
"name[The Cricketers], eatType[restaurant], food[Chinese], priceRange[cheap], customer rating[5 out of 5], area[riverside], familyFriendly[no], near[All Bar One]"	The Cricketers is a cheap restaurant that serves Chinese food in the riverside area near All Bar One. It is not family-friendly and has a customer rating of 5 out of 5.
"name[The Cricketers], eatType[restaurant], food[Chinese], priceRange[cheap], customer rating[5 out of 5], area[riverside], familyFriendly[yes], near[All Bar One]"	There is a cheap restaurant The Cricketers located near All Bar One in the riverside area. It is family friendly and has a 5 out of 5 customer rating.
"name[The Cricketers], eatType[restaurant], food[Chinese], priceRange[cheap], customer rating[average], area[city centre], familyFriendly[no], near[All Bar One]"	Near All Bar One in the city centre is a Chinese restaurant called The Cricketers. It has an average customer rating and is not family-friendly.
"name[The Cricketers], eatType[restaurant], food[Chinese], priceRange[cheap], customer rating[average], area[city centre], familyFriendly[yes], near[All Bar One]"	There is a cheap Chinese restaurant called The Cricketers located in the city centre near All Bar One. It has an average customer rating.
"name[The Cricketers], eatType[restaurant], food[Chinese], priceRange[cheap], customer rating[average], area[riverside], familyFriendly[no], near[All Bar One]"	In the riverside area near All Bar One is a Chinese restaurant called The Cricketers. It has an average customer rating and is not family-friendly.
"name[The Cricketers], eatType[restaurant], food[Chinese], priceRange[cheap], customer rating[average], area[riverside], familyFriendly[yes], near[All Bar One]"	The Cricketers is a cheap restaurant that serves Chinese food. It is located in the riverside area near All Bar One. It is family friendly and has an average customer rating.
"name[The Cricketers], eatType[restaurant], food[Chinese], priceRange[high], customer rating[1 out of 5], area[city centre], familyFriendly[no], near[All Bar One]"	The Cricketers is a high priced Chinese restaurant located in the city centre near All Bar One. It is not child friendly and has a customer rating of 1 out of 5.
"name[The Cricketers], eatType[restaurant], food[Chinese], priceRange[high], customer rating[1 out of 5], area[city centre], familyFriendly[yes], near[All Bar One]"	The Cricketers is a high priced restaurant that serves Chinese food. It is located in the city centre near All Bar One. It is child friendly and has a customer rating of 1 out of 5.
"name[The Cricketers], eatType[restaurant], food[Chinese], priceRange[high], customer rating[1 out of 5], area[riverside], familyFriendly[no], near[All Bar One]"	The Cricketers is a restaurant that serves Chinese food in the high price range. It is located in the riverside area near All Bar One. It is not child friendly and has a customer rating of 1 out of 5.
"name[The Cricketers], eatType[restaurant], food[Chinese], priceRange[high], customer rating[1 out of 5], area[riverside], familyFriendly[yes], near[All Bar One]"	At the riverside area is a high priced restaurant called The Cricketers. It is near All Bar One. It is child friendly and has a customer rating of 1 out of 5.
"name[The Cricketers], eatType[restaurant], food[Chinese], priceRange[high], customer rating[average], area[city centre], familyFriendly[no], near[All Bar One]"	The Cricketers is a high priced Chinese restaurant located in the city centre near All Bar One. It has an average customer rating and is not child friendly.
"name[The Cricketers], eatType[restaurant], food[Chinese], priceRange[high], customer rating[average], area[city centre], familyFriendly[yes], near[All Bar One]"	The Cricketers is a children friendly Chinese restaurant with an average customer rating and a high price range. It is located in the city centre near All Bar One.
"name[The Cricketers], eatType[restaurant], food[Chinese], priceRange[high], customer rating[average], area[riverside], familyFriendly[no], near[All Bar One]"	Along the riverside near All Bar One is a high priced Chinese restaurant called The Cricketers. It has an average customer rating.
"name[The Cricketers], eatType[restaurant], food[Chinese], priceRange[high], customer rating[average], area[riverside], familyFriendly[yes], near[All Bar One]"	The Cricketers is a restaurant that serves Chinese food in the high price range. It is located in the riverside area near All Bar One. It has an average customer rating.
"name[The Cricketers], eatType[restaurant], food[Chinese], priceRange[less than £20], customer rating[low], area[city centre], familyFriendly[no], near[All Bar One]"	The Cricketers is a Chinese restaurant located in the city centre near All Bar One. It has a low customer rating and is not family-friendly.
"name[The Cricketers], eatType[restaurant], food[Chinese], priceRange[less than £20], customer rating[low], area[city centre], familyFriendly[yes], near[All Bar One]"	"Located in the city centre near All Bar One, The Cricketers is a family friendly restaurant that serves Chinese food for less than £20."
"name[The Cricketers], eatType[restaurant], food[Chinese], priceRange[less than £20], customer rating[low], area[riverside], familyFriendly[no], near[All Bar One]"	The Cricketers is a restaurant that serves Chinese food for less than £20. It is located in the riverside area near All Bar One. It is not family-friendly.
"name[The Cricketers], eatType[restaurant], food[Chinese], priceRange[less than £20], customer rating[low], area[riverside], familyFriendly[yes], near[All Bar One]"	The Cricketers is a family friendly restaurant that serves Chinese food for less than £20. It is located near All Bar One in the riverside area.
"name[The Cricketers], eatType[restaurant], food[Chinese], priceRange[moderate], customer rating[1 out of 5], area[city centre], familyFriendly[no], near[All Bar One]"	The Cricketers is a moderately priced Chinese restaurant located in the city centre near All Bar One. It is not kid friendly and has a customer rating of 1 out of 5.
"name[The Cricketers], eatType[restaurant], food[Chinese], priceRange[moderate], customer rating[1 out of 5], area[city centre], familyFriendly[yes], near[All Bar One]"	There is a moderately priced Chinese restaurant called The Cricketers located in the city centre near All Bar One. It is kid friendly and has a customer rating of 1 out of 5.
"name[The Cricketers], eatType[restaurant], food[Chinese], priceRange[moderate], customer rating[1 out of 5], area[riverside], familyFriendly[no], near[All Bar One]"	The Cricketers is a moderately priced Chinese restaurant located near All Bar One in the riverside area. It is not kid friendly and has a customer rating of 1 out of 5.
"name[The Cricketers], eatType[restaurant], food[Chinese], priceRange[moderate], customer rating[1 out of 5], area[riverside], familyFriendly[yes], near[All Bar One]"	The Cricketers is a moderately priced Chinese restaurant located near All Bar One in the riverside area. It is kid friendly and has a customer rating of 1 out of 5.
"name[The Cricketers], eatType[restaurant], food[Chinese], priceRange[moderate], customer rating[3 out of 5], area[city centre], familyFriendly[no], near[All Bar One]"	This is a moderately priced Chinese restaurant near All Bar One in the city centre called The Cricketers. It is not kid friendly and has a customer rating of 3 out of 5.
"name[The Cricketers], eatType[restaurant], food[Chinese], priceRange[moderate], customer rating[3 out of 5], area[city centre], familyFriendly[yes], near[All Bar One]"	The Cricketers is a moderately priced Chinese restaurant located in the city centre near All Bar One. It is kid friendly and has a customer rating of 3 out of 5.
"name[The Cricketers], eatType[restaurant], food[Chinese], priceRange[moderate], customer rating[3 out of 5], area[riverside], familyFriendly[no], near[All Bar One]"	The Cricketers is a restaurant that serves Chinese food in the moderate price range. It is located in the riverside area near All Bar One. It is not kid friendly.
"name[The Cricketers], eatType[restaurant], food[Chinese], priceRange[moderate], customer rating[3 out of 5], area[riverside], familyFriendly[yes], near[All Bar One]"	A kid friendly restaurant in the riverside area near All Bar One is The Cricketers. It has a moderate price range and a customer rating of 3 out of 5.
"name[The Cricketers], eatType[restaurant], food[Chinese], priceRange[more than £30], customer rating[high], area[city centre], familyFriendly[no], near[All Bar One]"	The Cricketers is a highly rated Chinese restaurant in the city centre near All Bar One. It is not child friendly and has a price range of more than £30.
"name[The Cricketers], eatType[restaurant], food[Chinese], priceRange[more than £30], customer rating[high], area[city centre], familyFriendly[yes], near[All Bar One]"	The Cricketers is a children friendly Chinese restaurant with a high customer rating and a price range of more than £30. It is located in the city centre near All Bar One.
"name[The Cricketers], eatType[restaurant], food[Chinese], priceRange[more than £30], customer rating[high], area[riverside], familyFriendly[no], near[All Bar One]"	The Cricketers is a highly rated Chinese restaurant in the riverside area near All Bar One. It is not child friendly and has a price range of more than £30.
"name[The Cricketers], eatType[restaurant], food[Chinese], priceRange[more than £30], customer rating[high], area[riverside], familyFriendly[yes], near[All Bar One]"	The Cricketers is a high rated restaurant that serves Chinese food in the more than £30 price range. It is located in the riverside area near All Bar One.
"name[The Cricketers], eatType[restaurant], food[English], priceRange[£20-25], customer rating[high], area[city centre], familyFriendly[no], near[All Bar One]"	An English restaurant near All Bar One in the city centre is The Cricketers. It has a high customer rating and a price range of £20-25.
"name[The Cricketers], eatType[restaurant], food[English], priceRange[£20-25], customer rating[high], area[city centre], familyFriendly[yes], near[All Bar One]"	The Cricketers is a English restaurant with a high customer rating and a price range of £20-25. It is located in the city centre near All Bar One.
"name[The Cricketers], eatType[restaurant], food[English], priceRange[£20-25], customer rating[high], area[riverside], familyFriendly[no], near[All Bar One]"	"Located near All Bar One in the riverside area, The Cricketers is a highly rated English restaurant with a price range of £20-25."
"name[The Cricketers], eatType[restaurant], food[English], priceRange[£20-25], customer rating[high], area[riverside], familyFriendly[yes], near[All Bar One]"	Near All Bar One is a restaurant called The Cricketers that serves English food and is kid friendly. It has a high customer rating and a price range of £20-25.
"name[The Cricketers], eatType[restaurant], food[English], priceRange[cheap], customer rating[5 out of 5], area[city centre], familyFriendly[no], near[Café Rouge]"	There is a cheap English restaurant called The Cricketers located in the city centre near Café Rouge. It is not family-friendly and has a customer rating of 5 out of 5.
"name[The Cricketers], eatType[restaurant], food[English], priceRange[cheap], customer rating[5 out of 5], area[city centre], familyFriendly[yes], near[Café Rouge]"	There is a cheap English restaurant called The Cricketers located in the city centre near Café Rouge. It is family friendly and has a customer rating of 5 out of 5.
"name[The Cricketers], eatType[restaurant], food[English], priceRange[cheap], customer rating[5 out of 5], area[riverside], familyFriendly[no], near[Café Rouge]"	There is a cheap restaurant The Cricketers located in the riverside area near Café Rouge. It is not family-friendly and has a 5 out of 5 customer rating.
"name[The Cricketers], eatType[restaurant], food[English], priceRange[cheap], customer rating[5 out of 5], area[riverside], familyFriendly[yes], near[Café Rouge]"	There is a cheap restaurant The Cricketers located near Café Rouge in the riverside area. It is family friendly and has a 5 out of 5 customer rating.
"name[The Cricketers], eatType[restaurant], food[English], priceRange[cheap], customer rating[average], area[city centre], familyFriendly[no], near[Café Rouge]"	There is a cheap English restaurant near Café Rouge in the city centre called The Cricketers. It has an average customer rating and is not family-friendly.
"name[The Cricketers], eatType[restaurant], food[English], priceRange[cheap], customer rating[average], area[city centre], familyFriendly[yes], near[Café Rouge]"	The Cricketers is a cheap English restaurant located in the city centre near Café Rouge. It is family friendly and has an average customer rating.
"name[The Cricketers], eatType[restaurant], food[English], priceRange[cheap], customer rating[average], area[riverside], familyFriendly[no], near[Café Rouge]"	In the riverside area near Café Rouge is a English restaurant called The Cricketers. It has an average customer rating and is not family-friendly.
"name[The Cricketers], eatType[restaurant], food[English], priceRange[cheap], customer rating[average], area[riverside], familyFriendly[yes], near[Café Rouge]"	The Cricketers is a cheap restaurant that serves English food. It is located in the riverside area near Café Rouge. It is family friendly and has an average customer rating.
"name[The Cricketers], eatType[restaurant], food[English], priceRange[high], customer rating[1 out of 5], area[city centre], familyFriendly[no], near[Café Rouge]"	The Cricketers is a high priced English restaurant located in the city centre near Café Rouge. It has a customer rating of 1 out of 5.
"name[The Cricketers], eatType[restaurant], food[English], priceRange[high], customer rating[1 out of 5], area[city centre], familyFriendly[yes], near[Café Rouge]"	This restaurant The Cricketers is a high priced English restaurant located in the city centre near Café Rouge. It has a customer rating of 1 out of 5.
"name[The Cricketers], eatType[restaurant], food[English], priceRange[high], customer rating[1 out of 5], area[riverside], familyFriendly[no], near[Café Rouge]"	At the riverside area is a high priced English restaurant called The Cricketers. It is not child friendly and has a customer rating of 1 out of 5.
"name[The Cricketers], eatType[restaurant], food[English], priceRange[high], customer rating[1 out of 5], area[riverside], familyFriendly[yes], near[Café Rouge]"	There is a high priced restaurant The Cricketers located near Café Rouge in the riverside area. It is child friendly and has a customer rating of 1 out of 5.
"name[The Cricketers], eatType[restaurant], food[English], priceRange[high], customer rating[average], area[city centre], familyFriendly[no], near[Café Rouge]"	There is a high priced English restaurant near Café Rouge in the city centre called The Cricketers. It has an average customer rating and is not child friendly.
"name[The Cricketers], eatType[restaurant], food[English], priceRange[high], customer rating[average], area[city centre], familyFriendly[yes], near[Café Rouge]"	The Cricketers is a children friendly English restaurant with an average customer rating and a high price range. It is located in the city centre near Café Rouge.
"name[The Cricketers], eatType[restaurant], food[English], priceRange[high], customer rating[average], area[riverside], familyFriendly[no], near[Café Rouge]"	Near Café Rouge is a restaurant called The Cricketers that serves English food and has an average customer rating. It is not children friendly and has a high price range.
"name[The Mill], eatType[pub], food[English], priceRange[high], area[riverside], familyFriendly[yes], near[Raja Indian Cuisine]"	If you are looking for a high priced pub that serves English food in the riverside area is The Mill. It is child friendly and is located near Raja Indian Cuisine.
"name[The Mill], eatType[pub], food[English], priceRange[less than £20], area[city centre], familyFriendly[no], near[Raja Indian Cuisine]"	There is a pub called The Mill that serves English food in the city centre near Raja Indian Cuisine. It is not family-friendly and has a price range of less than £20.
"name[The Mill], eatType[pub], food[English], priceRange[less than £20], area[city centre], familyFriendly[yes], near[Raja Indian Cuisine]"	"Located in the city centre near Raja Indian Cuisine, The Mill is a family friendly pub that serves English food for less than £20."
"name[The Mill], eatType[pub], food[English], priceRange[less than £20], area[riverside], familyFriendly[no], near[Raja Indian Cuisine]"	There is a pub called The Mill that serves English food in the riverside area near Raja Indian Cuisine. It is not family-friendly and has a price range of less than £20.
"name[The Mill], eatType[pub], food[English], priceRange[less than £20], area[riverside], familyFriendly[yes], near[Raja Indian Cuisine]"	For a family friendly pub near Raja Indian Cuisine in the riverside area then The Mill serves English food for less than £20.
"name[The Mill], eatType[pub], food[English], priceRange[moderate], area[city centre], familyFriendly[no], near[Raja Indian Cuisine]"	An English pub near Raja Indian Cuisine in the city centre is The Mill. It is not kid friendly and has a moderate price range.
"name[The Mill], eatType[pub], food[English], priceRange[moderate], area[city centre], familyFriendly[yes], near[Raja Indian Cuisine]"	The Mill is a pub that serves English food in the moderate price range. It is located in the city centre near Raja Indian Cuisine. It is kid friendly.
"name[The Mill], eatType[pub], food[English], priceRange[moderate], area[riverside], familyFriendly[no], near[Raja Indian Cuisine]"	The Mill is a pub that serves English food in the moderate price range. It is located in the riverside area near Raja Indian Cuisine. It is not kid friendly.
"name[The Mill], eatType[pub], food[English], priceRange[moderate], area[riverside], familyFriendly[yes], near[Raja Indian Cuisine]"	A kid friendly pub near Raja Indian Cuisine in the riverside area is The Mill. It serves English food and has a moderate price range.
"name[The Mill], eatType[pub], food[English], priceRange[more than £30], area[riverside], familyFriendly[yes], near[Raja Indian Cuisine]"	There is a pub called The Mill that serves English food in the riverside area near Raja Indian Cuisine. It is child friendly and has a price range of more than £30.
"name[The Mill], eatType[pub], food[Fast food], priceRange[£20-25], area[riverside], familyFriendly[yes], near[Raja Indian Cuisine]"	A kid friendly pub near Raja Indian Cuisine in the riverside area is The Mill. It serves Fast food and has a price range of £20-25.
"name[The Mill], eatType[pub], food[Fast food], priceRange[£20-25], customer rating[high], area[city centre], familyFriendly[no], near[Café Rouge]"	Near Café Rouge in the city centre is a pub called The Mill that serves Fast food with a price range of £20-25. It has a high customer rating and is not kid friendly.
"name[The Mill], eatType[pub], food[Fast food], priceRange[£20-25], customer rating[high], area[city centre], familyFriendly[yes], near[Café Rouge]"	"Located in the city centre near Café Rouge, The Mill is a pub that serves Fast food with a price range of £20-25. It is kid friendly and has a high customer rating."
"name[The Mill], eatType[pub], food[Fast food], priceRange[£20-25], customer rating[high], area[riverside], familyFriendly[no], near[Café Rouge]"	In the riverside area near Café Rouge is a pub called The Mill that serves Fast food with a price range of £20-25. It has a high customer rating and is not kid friendly.
"name[The Mill], eatType[pub], food[Fast food], priceRange[£20-25], customer rating[high], area[riverside], familyFriendly[yes], near[Café Rouge]"	The Mill is a pub that serves Fast food in the £20-25 price range. It is located in the riverside area near Café Rouge. It is kid friendly and has a high customer rating.
"name[The Mill], eatType[pub], food[Fast food], priceRange[£20-25], customer rating[high], area[riverside], familyFriendly[yes], near[Café Sicilia]"	The Mill is a pub that serves Fast food in the £20-25 price range. It is located in the riverside area near Café Sicilia. It is kid friendly and has a high customer rating.
"name[The Mill], eatType[pub], food[Fast food], priceRange[cheap], area[riverside], familyFriendly[yes], near[Raja Indian Cuisine]"	Near Raja Indian Cuisine in the riverside area is a family friendly pub called The Mill. It serves Fast food and is cheap.
"name[The Mill], eatType[pub], food[Fast food], priceRange[cheap], customer rating[5 out of 5], area[city centre], familyFriendly[no], near[Café Sicilia]"	The Mill is a cheap Fast food pub located in the city centre near Café Sicilia. It has a customer rating of 5 out of 5 and is not family-friendly.
"name[The Mill], eatType[pub], food[Fast food], priceRange[cheap], customer rating[5 out of 5], area[city centre], familyFriendly[yes], near[Café Sicilia]"	The Mill is a cheap Fast food pub located in the city centre near Café Sicilia. It is family friendly and has a customer rating of 5 out of 5.
"name[The Mill], eatType[pub], food[Fast food], priceRange[cheap], customer rating[5 out of 5], area[riverside], familyFriendly[no], near[Café Sicilia]"	The Mill is a cheap Fast food pub located in the riverside area near Café Sicilia. It is not family-friendly and has a customer rating of 5 out of 5.
"name[The Mill], eatType[pub], food[Fast food], priceRange[cheap], customer rating[5 out of 5], area[riverside], familyFriendly[yes], near[Café Sicilia]"	"Located near Café Sicilia in the riverside area, The Mill is a cheap pub that serves Fast food. It is family friendly and has a customer rating of 5 out of 5."
"name[The Mill], eatType[pub], food[Fast food], priceRange[cheap], customer rating[average], area[city centre], familyFriendly[no], near[Café Sicilia]"	The Mill is a cheap Fast food pub located in the city centre near Café Sicilia. It has an average customer rating and is not family-friendly.
"name[The Mill], eatType[pub], food[Fast food], priceRange[cheap], customer rating[average], area[city centre], familyFriendly[yes], near[Café Sicilia]"	If you are looking for a cheap pub that serves Fast food in the city centre area near Café Sicilia is The Mill. It is family-friendly and has an average customer rating.
"name[The Mill], eatType[pub], food[Fast food], priceRange[cheap], customer rating[average], area[riverside], familyFriendly[no], near[Café Sicilia]"	The Mill is a cheap Fast food pub located in the riverside area near Café Sicilia. It has an average customer rating and is not family-friendly.
"name[The Mill], eatType[pub], food[Fast food], priceRange[cheap], customer rating[average], area[riverside], familyFriendly[yes], near[Café Sicilia]"	The Mill is a cheap pub that serves Fast food and is located in the riverside area near Café Sicilia. It is family friendly and has an average customer rating.
"name[The Mill], eatType[pub], food[Fast food], priceRange[high], customer rating[1 out of 5], area[city centre], familyFriendly[no], near[Café Sicilia]"	There is a pub called The Mill that serves Fast food in the city centre near Café Sicilia. It has a high price range and a customer rating of 1 out of 5. It is not child friendly.
"name[The Mill], eatType[pub], food[Fast food], priceRange[high], customer rating[1 out of 5], area[city centre], familyFriendly[yes], near[Café Sicilia]"	"Located in the city centre near Café Sicilia, The Mill is a high priced pub that serves Fast food. It is child friendly and has a customer rating of 1 out of 5."
"name[The Mill], eatType[pub], food[Fast food], priceRange[high], customer rating[1 out of 5], area[riverside], familyFriendly[no], near[Café Sicilia]"	The Mill is a pub that serves Fast food in the riverside area near Café Sicilia. It has a high price range and a customer rating of 1 out of 5. It is not child friendly.
"name[The Mill], eatType[pub], food[Fast food], priceRange[high], customer rating[1 out of 5], area[riverside], familyFriendly[yes], near[Café Sicilia]"	"Located near Café Sicilia in the riverside area, The Mill is a high priced pub that serves Fast food. It is child friendly and has a customer rating of 1 out of 5."
"name[The Mill], eatType[pub], food[Fast food], priceRange[high], customer rating[average], area[city centre], familyFriendly[no], near[Café Sicilia]"	The Mill is a pub that serves Fast food in the high price range. It is located in the city centre near Café Sicilia. It has an average customer rating and is not child friendly.
"name[The Mill], eatType[pub], food[Fast food], priceRange[high], customer rating[average], area[city centre], familyFriendly[yes], near[Café Sicilia]"	The Mill is a pub that serves Fast food in the high price range. It is located in the city centre near Café Sicilia. It is children friendly and has an average customer rating.
"name[The Mill], eatType[pub], food[Fast food], priceRange[high], customer rating[average], area[riverside], familyFriendly[no], near[Café Sicilia]"	The Mill is a pub that serves Fast food in the high price range. It is located in the riverside area near Café Sicilia. It has an average customer rating and is not child friendly.
"name[The Mill], eatType[pub], food[Fast food], priceRange[high], customer rating[average], area[riverside], familyFriendly[yes], near[Café Sicilia]"	The Mill is a pub that serves Fast food in the high price range. It is located in the riverside area near Café Sicilia. It is children friendly and has an average customer rating.
"name[The Mill], eatType[pub], food[Fast food], priceRange[less than £20], customer rating[low], area[city centre], familyFriendly[no], near[Café Sicilia]"	The Mill is a pub that serves Fast food for less than £20. It is located in the city centre near Café Sicilia. It is not family-friendly and has a low customer rating.
"name[The Mill], eatType[pub], food[Fast food], priceRange[less than £20], customer rating[low], area[city centre], familyFriendly[yes], near[Café Sicilia]"	A family-friendly pub near Café Sicilia in the city centre is The Mill. It has a low customer rating and serves Fast food for less than £20.
"name[The Mill], eatType[pub], food[Fast food], priceRange[less than £20], customer rating[low], area[riverside], familyFriendly[no], near[Café Sicilia]"	The Mill is a pub that serves Fast food in the less than £20 price range. It is located in the riverside area near Café Sicilia. It is not family-friendly and has a low customer rating.
"name[The Mill], eatType[pub], food[Fast food], priceRange[less than £20], customer rating[low], area[riverside], familyFriendly[yes], near[Café Sicilia]"	There is a family friendly pub called The Mill that serves Fast food in the riverside area near Café Sicilia. It has a low customer rating and a price range of less than £20.
"name[The Mill], eatType[pub], food[Fast food], priceRange[moderate], customer rating[1 out of 5], area[city centre], familyFriendly[no], near[Café Sicilia]"	The Mill is a moderately priced Fast food pub located in the city centre near Café Sicilia. It is not kid friendly and has a customer rating of 1 out of 5.
"name[The Mill], eatType[pub], food[Fast food], priceRange[moderate], customer rating[1 out of 5], area[city centre], familyFriendly[yes], near[Café Sicilia]"	Near Café Sicilia in the city centre is a pub called The Mill that serves Fast food and is kid friendly. It has a moderate price range and a customer rating of 1 out of 5.
"name[The Mill], eatType[pub], food[Fast food], priceRange[moderate], customer rating[1 out of 5], area[riverside], familyFriendly[no], near[Café Sicilia]"	In the riverside area near Café Sicilia is a pub called The Mill that serves Fast food and is not kid friendly. It has a moderate price range and a customer rating of 1 out of 5.
"name[The Mill], eatType[pub], food[Fast food], priceRange[moderate], customer rating[1 out of 5], area[riverside], familyFriendly[yes], near[Café Sicilia]"	At the riverside near Café Sicilia is a pub called The Mill that serves Fast food and is kid friendly. It has a moderate price range and a customer rating of 1 out of 5.
"name[The Mill], eatType[pub], food[Fast food], priceRange[moderate], customer rating[3 out of 5], area[city centre], familyFriendly[no], near[Café Sicilia]"	There is a moderately priced Fast food pub near Café Sicilia in the city centre called The Mill. It is not kid friendly and has a customer rating of 3 out of 5.
"name[The Mill], eatType[pub], food[Fast food], priceRange[moderate], customer rating[3 out of 5], area[city centre], familyFriendly[yes], near[Café Sicilia]"	In the city centre near Café Sicilia is a pub called The Mill. It serves Fast food and is kid friendly. It has a moderate price range and a customer rating of 3 out of 5.
"name[The Mill], eatType[pub], food[Fast food], priceRange[moderate], customer rating[3 out of 5], area[riverside], familyFriendly[no], near[Café Sicilia]"	At the riverside near Café Sicilia is a pub called The Mill. It serves Fast food and is not kid friendly. It has a moderate price range and a customer rating of 3 out of 5.
"name[The Mill], eatType[pub], food[Fast food], priceRange[moderate], customer rating[3 out of 5], area[riverside], familyFriendly[yes], near[Café Sicilia]"	The Mill is a pub that serves Fast food in the moderate price range. It is located in the riverside area near Café Sicilia. It is kid friendly and has a customer rating of 3 out of 5.
"name[The Mill], eatType[restaurant], food[English], priceRange[high], area[riverside], familyFriendly[yes], near[Raja Indian Cuisine]"	If you are looking for a high priced restaurant that is child friendly in the riverside area near Raja Indian Cuisine is The Mill.
"name[The Mill], eatType[restaurant], food[English], priceRange[high], customer rating[average], area[riverside], familyFriendly[yes], near[Café Rouge]"	The Mill is a restaurant that serves English food in the high price range. It is located in the riverside area near Café Rouge. It has an average customer rating.
"name[The Mill], eatType[restaurant], food[English], priceRange[less than £20], area[city centre], familyFriendly[no], near[Raja Indian Cuisine]"	Near Raja Indian Cuisine is a English restaurant called The Mill. It is not family-friendly and has a price range of less than £20.
"name[The Mill], eatType[restaurant], food[English], priceRange[less than £20], area[city centre], familyFriendly[yes], near[Raja Indian Cuisine]"	The Mill is a family-friendly restaurant that serves English food for less than £20. It is located in the city centre near Raja Indian Cuisine.
"name[The Mill], eatType[restaurant], food[English], priceRange[less than £20], area[riverside], familyFriendly[no], near[Raja Indian Cuisine]"	In the riverside area near Raja Indian Cuisine is a English restaurant called The Mill. It is not family-friendly and has a price range of less than £20.
"name[The Mill], eatType[restaurant], food[English], priceRange[less than £20], area[riverside], familyFriendly[yes], near[Raja Indian Cuisine]"	The Mill is a family friendly restaurant that serves English food for less than £20. It is located near Raja Indian Cuisine in the riverside area.
"name[The Mill], eatType[restaurant], food[English], priceRange[less than £20], customer rating[low], area[city centre], familyFriendly[no], near[Café Rouge]"	The Mill is a English restaurant located in the city centre near Café Rouge. It has a low customer rating and is not family-friendly.
"name[The Mill], eatType[restaurant], food[English], priceRange[less than £20], customer rating[low], area[city centre], familyFriendly[yes], near[Café Rouge]"	A family-friendly restaurant in the city centre near Café Rouge is The Mill. It has a low customer rating and serves English food.
"name[The Mill], eatType[restaurant], food[English], priceRange[less than £20], customer rating[low], area[riverside], familyFriendly[no], near[Café Rouge]"	In the riverside area near Café Rouge is a English restaurant called The Mill. It has a low customer rating and is not family-friendly.
"name[The Mill], eatType[restaurant], food[English], priceRange[less than £20], customer rating[low], area[riverside], familyFriendly[yes], near[Café Rouge]"	If you are looking for a family friendly restaurant that serves English food in the riverside area near Café Rouge then the Mill. It has a low customer rating.
"name[The Mill], eatType[restaurant], food[English], priceRange[moderate], area[city centre], familyFriendly[no], near[Raja Indian Cuisine]"	English restaurant The Mill is located in the city centre near Raja Indian Cuisine. It is not kid friendly and has a moderate price range.
"name[The Mill], eatType[restaurant], food[English], priceRange[moderate], area[city centre], familyFriendly[yes], near[Raja Indian Cuisine]"	In the city centre near Raja Indian Cuisine is a English restaurant called The Mill. It is kid friendly and has a moderate price range.
"name[The Mill], eatType[restaurant], food[English], priceRange[moderate], area[riverside], familyFriendly[no], near[Raja Indian Cuisine]"	In the riverside area near Raja Indian Cuisine is a English restaurant called The Mill. It is not kid friendly and has a moderate price range.
"name[The Mill], eatType[restaurant], food[English], priceRange[moderate], area[riverside], familyFriendly[yes], near[Raja Indian Cuisine]"	"Located near Raja Indian Cuisine in the riverside area, The Mill is a kid friendly restaurant that serves English food at a moderate price."
"name[The Mill], eatType[restaurant], food[English], priceRange[moderate], customer rating[1 out of 5], area[city centre], familyFriendly[no], near[Café Rouge]"	An English restaurant named The Mill is located in the city centre near Café Rouge. It is not kid friendly and has a moderate price range.
"name[The Mill], eatType[restaurant], food[English], priceRange[moderate], customer rating[1 out of 5], area[city centre], familyFriendly[yes], near[Café Rouge]"	The Mill is a moderately priced English restaurant located in the city centre near Café Rouge. It is kid friendly and has a customer rating of 1 out of 5.
"name[The Mill], eatType[restaurant], food[English], priceRange[moderate], customer rating[1 out of 5], area[riverside], familyFriendly[no], near[Café Rouge]"	The Mill is a moderately priced English restaurant located near Café Rouge in the riverside area. It is not kid friendly.
"name[The Mill], eatType[restaurant], food[English], priceRange[moderate], customer rating[1 out of 5], area[riverside], familyFriendly[yes], near[Café Rouge]"	At the riverside area is a moderately priced English restaurant called The Mill. It is kid friendly and has a customer rating of 1 out of 5.
"name[The Mill], eatType[restaurant], food[English], priceRange[moderate], customer rating[3 out of 5], area[city centre], familyFriendly[no], near[Café Rouge]"	English restaurant The Mill is located in the city centre near Café Rouge. It is not kid friendly and has a moderate price range.
"name[The Mill], eatType[restaurant], food[English], priceRange[moderate], customer rating[3 out of 5], area[city centre], familyFriendly[yes], near[Café Rouge]"	There is a moderately priced English restaurant called The Mill located in the city centre near Café Rouge. It is kid friendly and has a customer rating of 3 out of 5.
"name[The Mill], eatType[restaurant], food[English], priceRange[moderate], customer rating[3 out of 5], area[riverside], familyFriendly[no], near[Café Rouge]"	In the riverside area near Café Rouge is a English restaurant called The Mill. It is not kid friendly and has a moderate price range.
"name[The Mill], eatType[restaurant], food[English], priceRange[moderate], customer rating[3 out of 5], area[riverside], familyFriendly[yes], near[Café Rouge]"	The Mill is a restaurant that serves English food in the moderate price range. It is located in the riverside area near Café Rouge. It is kid friendly and has a customer rating of 3 out of 5.
"name[The Mill], eatType[restaurant], food[English], priceRange[more than £30], area[riverside], familyFriendly[yes], near[Raja Indian Cuisine]"	The Mill is a restaurant that serves English food in the riverside area near Raja Indian Cuisine. It is child friendly and has a price range of more than £30.
"name[The Mill], eatType[restaurant], food[English], priceRange[more than £30], customer rating[high], area[city centre], familyFriendly[no], near[Café Rouge]"	There is a highly rated English restaurant called The Mill in the city centre near Café Rouge. It is not child friendly and has a price range of more than £30.
"name[The Mill], eatType[restaurant], food[English], priceRange[more than £30], customer rating[high], area[city centre], familyFriendly[yes], near[Café Rouge]"	The Mill is a highly rated English restaurant in the city centre near Café Rouge. It is child friendly and has a price range of more than £30.
"name[The Mill], eatType[restaurant], food[English], priceRange[more than £30], customer rating[high], area[riverside], familyFriendly[no], near[Café Rouge]"	The Mill is a highly rated English restaurant in the riverside area near Café Rouge. It is not child friendly and has a price range of more than £30.
"name[The Mill], eatType[restaurant], food[English], priceRange[more than £30], customer rating[high], area[riverside], familyFriendly[yes], near[Café Rouge]"	The Mill is a high rated English restaurant in the riverside area near Café Rouge. It is child friendly and has a price range of more than £30.
"name[The Mill], eatType[restaurant], food[Fast food], priceRange[£20-25], area[riverside], familyFriendly[yes], near[Raja Indian Cuisine]"	Near Raja Indian Cuisine in the riverside area is a kid friendly restaurant called The Mill. It serves Fast food and is in the £20-25 price range.
"name[The Mill], eatType[restaurant], food[Fast food], priceRange[cheap], area[riverside], familyFriendly[yes], near[Raja Indian Cuisine]"	A cheap restaurant in the riverside area near Raja Indian Cuisine is The Mill. It is family friendly.
"name[The Phoenix], eatType[pub], food[Fast food], priceRange[cheap], area[riverside], familyFriendly[yes], near[Raja Indian Cuisine]"	If you are looking for a cheap pub that serves Fast food in the riverside area then the Phoenix is family friendly. It is located near Raja Indian Cuisine.
"name[The Phoenix], eatType[pub], food[Fast food], priceRange[high], area[city centre], familyFriendly[no], near[Raja Indian Cuisine]"	For a high priced Fast food pub near Raja Indian Cuisine in the city centre there is The Phoenix. It is not child friendly.
"name[The Phoenix], eatType[pub], food[Fast food], priceRange[high], area[city centre], familyFriendly[yes], near[Raja Indian Cuisine]"	The Phoenix is a pub that serves Fast food in the high price range. It is located in the city centre near Raja Indian Cuisine. It is children friendly.
"name[The Phoenix], eatType[pub], food[Fast food], priceRange[high], area[riverside], familyFriendly[no], near[Raja Indian Cuisine]"	The Phoenix is a pub that serves Fast food in the high price range. It is located in the riverside area near Raja Indian Cuisine. It is not child friendly.
"name[The Phoenix], eatType[pub], food[Fast food], priceRange[high], area[riverside], familyFriendly[yes], near[Raja Indian Cuisine]"	If you are looking for a high priced pub that serves Fast food in the riverside area is The Phoenix. It is child friendly and is located near Raja Indian Cuisine.
"name[The Phoenix], eatType[pub], food[Fast food], priceRange[less than £20], area[city centre], familyFriendly[no], near[Raja Indian Cuisine]"	Fast food is served at The Phoenix pub in the city centre near Raja Indian Cuisine. It is not family-friendly and has a price range of less than £20.
"name[The Phoenix], eatType[pub], food[Fast food], priceRange[less than £20], area[city centre], familyFriendly[yes], near[Raja Indian Cuisine]"	"Located in the city centre near Raja Indian Cuisine, The Phoenix is a family friendly pub that serves Fast food for less than £20."
"name[The Phoenix], eatType[pub], food[Fast food], priceRange[less than £20], area[riverside], familyFriendly[no], near[Raja Indian Cuisine]"	There is a pub called The Phoenix that serves Fast food in the riverside area near Raja Indian Cuisine. It is not family-friendly and has a price range of less than £20.
"name[The Phoenix], eatType[pub], food[Fast food], priceRange[less than £20], area[riverside], familyFriendly[yes], near[Raja Indian Cuisine]"	The Phoenix is a family friendly pub that serves Fast food for less than £20. It is located in the riverside area near Raja Indian Cuisine.
"name[The Phoenix], eatType[pub], food[Fast food], priceRange[moderate], area[city centre], familyFriendly[no], near[Raja Indian Cuisine]"	The Phoenix is a pub that serves Fast food in the moderate price range. It is located in the city centre near Raja Indian Cuisine. It is not kid friendly.
"name[The Phoenix], eatType[pub], food[Fast food], priceRange[moderate], area[city centre], familyFriendly[yes], near[Raja Indian Cuisine]"	There is a moderately priced pub The Phoenix located in the city centre near Raja Indian Cuisine. It serves Fast food and is kid friendly.
"name[The Phoenix], eatType[pub], food[Fast food], priceRange[moderate], area[riverside], familyFriendly[no], near[Raja Indian Cuisine]"	"Located near Raja Indian Cuisine in the riverside area, The Phoenix is a moderately priced Fast food pub that is not kid friendly."
"name[The Phoenix], eatType[pub], food[Fast food], priceRange[moderate], area[riverside], familyFriendly[yes], near[Raja Indian Cuisine]"	A kid friendly pub near Raja Indian Cuisine in the riverside area is The Phoenix. It serves Fast food and has a moderate price range.
"name[The Phoenix], eatType[pub], food[Fast food], priceRange[moderate], customer rating[3 out of 5], area[riverside], familyFriendly[yes], near[Café Sicilia]"	The Phoenix is a pub that serves Fast food in the moderate price range. It is located in the riverside area near Café Sicilia. It is kid friendly and has a customer rating of 3 out of 5.
"name[The Phoenix], eatType[pub], food[Fast food], priceRange[more than £30], area[riverside], familyFriendly[yes], near[Raja Indian Cuisine]"	There is a pub called The Phoenix that serves Fast food in the riverside area near Raja Indian Cuisine. It is child friendly and has a price range of more than £30.
"name[The Phoenix], eatType[pub], food[Fast food], priceRange[more than £30], customer rating[high], area[city centre], familyFriendly[no], near[Café Sicilia]"	The Phoenix is a pub that serves Fast food in the more than £30 price range. It is located in the city centre near Café Sicilia. It is not child friendly and has a high customer rating.
"name[The Phoenix], eatType[pub], food[Fast food], priceRange[more than £30], customer rating[high], area[city centre], familyFriendly[yes], near[Café Sicilia]"	The Phoenix is a pub that serves Fast food in the more than £30 price range. It is located in the city centre near Café Sicilia. It is child friendly and has a high customer rating.
"name[The Phoenix], eatType[pub], food[Fast food], priceRange[more than £30], customer rating[high], area[riverside], familyFriendly[no], near[Café Sicilia]"	The Phoenix is a highly rated pub that serves Fast food in the riverside area near Café Sicilia. It is not child friendly and has a price range of more than £30.
"name[The Phoenix], eatType[pub], food[Fast food], priceRange[more than £30], customer rating[high], area[riverside], familyFriendly[yes], near[Café Sicilia]"	Café Sicilia is a high rated Fast food pub near Café Sicilia in the riverside area that is child friendly and has a price range of more than £30.
"name[The Phoenix], eatType[pub], food[French], priceRange[£20-25], area[riverside], familyFriendly[yes], near[Raja Indian Cuisine]"	"Located near Raja Indian Cuisine in the riverside area, The Phoenix is a kid friendly pub that serves French food and has a price range of £20-25."
"name[The Phoenix], eatType[pub], food[French], priceRange[£20-25], customer rating[3 out of 5], area[city centre], familyFriendly[no], near[Café Sicilia]"	"Located in the city centre near Café Sicilia, The Phoenix is a French pub with a price range of £20-25. It is not kid friendly and has a customer rating of 3 out of 5."
"name[The Phoenix], eatType[pub], food[French], priceRange[£20-25], customer rating[3 out of 5], area[city centre], familyFriendly[yes], near[Café Sicilia]"	"Located in the city centre near Café Sicilia, The Phoenix is a kid friendly pub with a customer rating of 3 out of 5. It serves French food and is in the £20-25 price range."
"name[The Phoenix], eatType[pub], food[French], priceRange[£20-25], customer rating[3 out of 5], area[riverside], familyFriendly[no], near[Café Sicilia]"	"Located near Café Sicilia in the riverside area, The Phoenix is a French pub with a price range of £20-25. It is not kid friendly and has a customer rating of 3 out of 5."
"name[The Phoenix], eatType[pub], food[French], priceRange[£20-25], customer rating[3 out of 5], area[riverside], familyFriendly[yes], near[Café Sicilia]"	"Located near Café Sicilia in the riverside area, The Phoenix is a kid friendly pub with a customer rating of 3 out of 5. It serves French food and is in the £20-25 price range."
"name[The Phoenix], eatType[pub], food[French], priceRange[£20-25], customer rating[3 out of 5], area[riverside], familyFriendly[yes], near[Crowne Plaza Hotel]"	"Located near Crowne Plaza Hotel in the riverside area, The Phoenix is a kid friendly pub with a customer rating of 3 out of 5. It serves French food and is in the £20-25 price range."
"name[The Phoenix], eatType[pub], food[French], priceRange[£20-25], customer rating[high], area[city centre], familyFriendly[no], near[Crowne Plaza Hotel]"	In the city centre near Crowne Plaza Hotel is a pub called The Phoenix that serves French food with a price range of £20-25. It has a high customer rating and is not kid friendly.
"name[The Phoenix], eatType[pub], food[French], priceRange[£20-25], customer rating[high], area[city centre], familyFriendly[yes], near[Crowne Plaza Hotel]"	"Located in the city centre near Crowne Plaza Hotel, The Phoenix is a pub that serves French food with a price range of £20-25. It is kid friendly and has a high customer rating."
"name[The Phoenix], eatType[pub], food[French], priceRange[£20-25], customer rating[high], area[riverside], familyFriendly[no], near[Crowne Plaza Hotel]"	"Located near Crowne Plaza Hotel in the riverside area, The Phoenix is a pub that serves French food with a price range of £20-25. It is not kid friendly and has a high customer rating."
"name[The Phoenix], eatType[pub], food[French], priceRange[£20-25], customer rating[high], area[riverside], familyFriendly[yes], near[Crowne Plaza Hotel]"	The Phoenix is a pub that serves French food in the riverside area near Crowne Plaza Hotel. It has a high customer rating and is kid friendly.
"name[The Phoenix], eatType[pub], food[French], priceRange[cheap], area[riverside], familyFriendly[yes], near[Raja Indian Cuisine]"	If you are looking for a cheap pub that serves French food in the riverside area then the Phoenix is family friendly. It is located near Raja Indian Cuisine.
"name[The Phoenix], eatType[pub], food[French], priceRange[cheap], customer rating[5 out of 5], area[city centre], familyFriendly[no], near[Crowne Plaza Hotel]"	The Phoenix is a cheap French pub located in the city centre near Crowne Plaza Hotel. It has a customer rating of 5 out of 5 and is not family-friendly.
"name[The Phoenix], eatType[pub], food[French], priceRange[cheap], customer rating[5 out of 5], area[city centre], familyFriendly[yes], near[Crowne Plaza Hotel]"	The Phoenix is a cheap French pub located in the city centre near Crowne Plaza Hotel. It is family friendly and has a customer rating of 5 out of 5.
"name[The Phoenix], eatType[pub], food[French], priceRange[cheap], customer rating[5 out of 5], area[riverside], familyFriendly[no], near[Crowne Plaza Hotel]"	There is a cheap pub named The Phoenix that serves French food near Crowne Plaza Hotel in the riverside area. It is not family-friendly and has a customer rating of 5 out of 5.
"name[The Phoenix], eatType[pub], food[French], priceRange[cheap], customer rating[5 out of 5], area[riverside], familyFriendly[yes], near[Crowne Plaza Hotel]"	There is a cheap pub named The Phoenix that serves French food in the riverside area near Crowne Plaza Hotel. It is family friendly and has a customer rating of 5 out of 5.
"name[The Phoenix], eatType[pub], food[French], priceRange[high], area[riverside], familyFriendly[yes], near[Raja Indian Cuisine]"	If you are looking for a high priced pub that serves French food in the riverside area is The Phoenix. It is child friendly and is located near Raja Indian Cuisine.
"name[The Phoenix], eatType[pub], food[French], priceRange[high], customer rating[3 out of 5], area[city centre], familyFriendly[no], near[Crowne Plaza Hotel]"	The Phoenix is a pub that serves French food in the city centre near Crowne Plaza Hotel. It has a high price range and a customer rating of 3 out of 5. It is not child friendly.
"name[The Phoenix], eatType[pub], food[French], priceRange[high], customer rating[3 out of 5], area[city centre], familyFriendly[yes], near[Crowne Plaza Hotel]"	The Phoenix is a pub that serves French food in the high price range. It is located in the city centre near Crowne Plaza Hotel. It is child friendly and has a customer rating of 3 out of 5.
"name[The Phoenix], eatType[pub], food[French], priceRange[high], customer rating[3 out of 5], area[riverside], familyFriendly[no], near[Crowne Plaza Hotel]"	The Phoenix is a pub that serves French food in the riverside area near Crowne Plaza Hotel. It has a high price range and a customer rating of 3 out of 5. It is not child friendly.
"name[The Phoenix], eatType[pub], food[French], priceRange[high], customer rating[3 out of 5], area[riverside], familyFriendly[yes], near[Crowne Plaza Hotel]"	The Phoenix is a pub that serves French food in the high price range. It is located in the riverside area near Crowne Plaza Hotel. It is child friendly and has a customer rating of 3 out of 5.
"name[The Phoenix], eatType[pub], food[French], priceRange[less than £20], customer rating[average], area[city centre], familyFriendly[no], near[Crowne Plaza Hotel]"	In the city centre near Crowne Plaza Hotel is a pub called The Phoenix that serves French food for less than £20. It has an average customer rating and is not family-friendly.
"name[The Phoenix], eatType[pub], food[French], priceRange[less than £20], customer rating[average], area[city centre], familyFriendly[yes], near[Crowne Plaza Hotel]"	"Located in the city centre near Crowne Plaza Hotel, The Phoenix is a family friendly pub with an average customer rating. It serves French food for less than £20."
"name[The Phoenix], eatType[pub], food[French], priceRange[less than £20], customer rating[average], area[riverside], familyFriendly[no], near[Crowne Plaza Hotel]"	The Phoenix is a pub that serves French food in the less than £20 price range. It is located in the riverside area near Crowne Plaza Hotel. It has an average customer rating and is not family-friendly.
"name[The Phoenix], eatType[pub], food[French], priceRange[less than £20], customer rating[average], area[riverside], familyFriendly[yes], near[Crowne Plaza Hotel]"	Near Crowne Plaza Hotel in the riverside area is a family friendly pub called The Phoenix. It serves French food and has an average customer rating.
"name[The Phoenix], eatType[pub], food[French], priceRange[less than £20], customer rating[low], area[city centre], familyFriendly[no], near[Crowne Plaza Hotel]"	Near Crowne Plaza Hotel in the city centre is a pub called The Phoenix. It serves French food and is not family-friendly. It has a low customer rating and a price range of less than £20.
"name[The Phoenix], eatType[pub], food[French], priceRange[less than £20], customer rating[low], area[city centre], familyFriendly[yes], near[Crowne Plaza Hotel]"	A family-friendly pub near Crowne Plaza Hotel in the city centre is The Phoenix. It has a low customer rating and serves French food for less than £20.
"name[The Phoenix], eatType[pub], food[French], priceRange[less than £20], customer rating[low], area[riverside], familyFriendly[no], near[Crowne Plaza Hotel]"	The Phoenix is a pub that serves French food in the less than £20 price range. It is located in the riverside area near Crowne Plaza Hotel. It is not family-friendly and has a low customer rating.
"name[The Phoenix], eatType[pub], food[French], priceRange[less than £20], customer rating[low], area[riverside], familyFriendly[yes], near[Crowne Plaza Hotel]"	There is a family friendly pub called The Phoenix that serves French food in the riverside area near Crowne Plaza Hotel. It has a low customer rating and a price range of less than £20.
"name[The Phoenix], eatType[pub], food[French], priceRange[moderate], customer rating[1 out of 5], area[city centre], familyFriendly[no], near[Crowne Plaza Hotel]"	The Phoenix is a moderately priced French pub located in the city centre near Crowne Plaza Hotel. It is not kid friendly and has a customer rating of 1 out of 5.
"name[The Phoenix], eatType[pub], food[French], priceRange[moderate], customer rating[1 out of 5], area[city centre], familyFriendly[yes], near[Crowne Plaza Hotel]"	In the city centre near Crowne Plaza Hotel is a pub called The Phoenix that serves French food and is kid friendly. It has a moderate price range and a customer rating of 1 out of 5.
"name[The Phoenix], eatType[pub], food[French], priceRange[moderate], customer rating[1 out of 5], area[riverside], familyFriendly[no], near[Crowne Plaza Hotel]"	At the riverside near Crowne Plaza Hotel is a pub called The Phoenix that serves French food and is not kid friendly. It has a moderate price range and a customer rating of 1 out of 5.
"name[The Phoenix], eatType[pub], food[French], priceRange[moderate], customer rating[1 out of 5], area[riverside], familyFriendly[yes], near[Crowne Plaza Hotel]"	The Phoenix is a pub that serves French food in the moderate price range. It is located in the riverside area near Crowne Plaza Hotel. It is kid friendly and has a customer rating of 1 out of 5.
"name[The Phoenix], eatType[pub], food[French], priceRange[more than £30], customer rating[5 out of 5], area[city centre], familyFriendly[no], near[Crowne Plaza Hotel]"	The Phoenix is a pub that serves French food in the city centre near Crowne Plaza Hotel. It has a high customer rating and is not child friendly.
"name[The Phoenix], eatType[pub], food[French], priceRange[more than £30], customer rating[5 out of 5], area[city centre], familyFriendly[yes], near[Crowne Plaza Hotel]"	If you are looking for a children friendly pub that serves French food in the city centre near Crowne Plaza Hotel then the Phoenix is a high priced pub with a customer rating of 5 out of 5.
"name[The Phoenix], eatType[pub], food[French], priceRange[more than £30], customer rating[5 out of 5], area[riverside], familyFriendly[no], near[Crowne Plaza Hotel]"	"Located near Crowne Plaza Hotel in the riverside area, The Phoenix is a pub that serves French food and is not child friendly. It has a high customer rating and a price range of more than £30."
"name[The Phoenix], eatType[pub], food[French], priceRange[more than £30], customer rating[5 out of 5], area[riverside], familyFriendly[yes], near[Crowne Plaza Hotel]"	If you are looking for a children friendly pub near Crowne Plaza Hotel in the riverside area then The Phoenix serves French food. The price range is more than £30.  It has a customer rating of 5 out of 5.
"name[The Phoenix], eatType[pub], food[French], priceRange[more than £30], customer rating[low], area[city centre], familyFriendly[no], near[Crowne Plaza Hotel]"	"Located in the city centre near Crowne Plaza Hotel, The Phoenix is a pub that serves French food with a price range of more than £30. It is not child friendly and has a low customer rating."
"name[The Phoenix], eatType[pub], food[French], priceRange[more than £30], customer rating[low], area[city centre], familyFriendly[yes], near[Crowne Plaza Hotel]"	In the city centre near Crowne Plaza Hotel is a pub called The Phoenix. It serves French food and is children friendly and has a low customer rating.
"name[The Phoenix], eatType[pub], food[French], priceRange[more than £30], customer rating[low], area[riverside], familyFriendly[no], near[Crowne Plaza Hotel]"	"Located near Crowne Plaza Hotel in the riverside area, The Phoenix is a pub that serves French food with a price range of more than £30. It is not child friendly and has a low customer rating."
"name[The Phoenix], eatType[pub], food[French], priceRange[more than £30], customer rating[low], area[riverside], familyFriendly[yes], near[Crowne Plaza Hotel]"	Near Crowne Plaza Hotel in the riverside area is a pub called The Phoenix. It is children friendly and has a low customer rating.
"name[The Phoenix], eatType[restaurant], food[Fast food], priceRange[cheap], area[riverside], familyFriendly[yes], near[Raja Indian Cuisine]"	Near Raja Indian Cuisine is a cheap restaurant called The Phoenix that is family friendly.
"name[The Phoenix], eatType[restaurant], food[Fast food], priceRange[high], area[city centre], familyFriendly[no], near[Raja Indian Cuisine]"	"If you are looking for a high priced Fast food restaurant in the city centre near Raja Indian Cuisine, then The Phoenix is not child friendly."
"name[The Phoenix], eatType[restaurant], food[Fast food], priceRange[high], area[city centre], familyFriendly[yes], near[Raja Indian Cuisine]"	The Phoenix is a children friendly restaurant that serves Fast food in the high price range. It is located in the city centre near Raja Indian Cuisine.
"name[The Phoenix], eatType[restaurant], food[Fast food], priceRange[high], area[riverside], familyFriendly[no], near[Raja Indian Cuisine]"	In the riverside area near Raja Indian Cuisine is a high priced Fast food restaurant called The Phoenix.
"name[The Phoenix], eatType[restaurant], food[Fast food], priceRange[high], area[riverside], familyFriendly[yes], near[Raja Indian Cuisine]"	There is a high priced restaurant The Phoenix located near Raja Indian Cuisine in the riverside area. It is child friendly.
"name[The Phoenix], eatType[restaurant], food[Fast food], priceRange[less than £20], area[city centre], familyFriendly[no], near[Raja Indian Cuisine]"	"Located in the city centre near Raja Indian Cuisine, The Phoenix is a Fast food restaurant with a price range of less than £20."
"name[The Phoenix], eatType[restaurant], food[Fast food], priceRange[less than £20], area[city centre], familyFriendly[yes], near[Raja Indian Cuisine]"	There is a family-friendly restaurant called The Phoenix that serves Fast food for less than £20. It is located in the city centre near Raja Indian Cuisine.
"name[The Phoenix], eatType[restaurant], food[Fast food], priceRange[less than £20], area[riverside], familyFriendly[no], near[Raja Indian Cuisine]"	There is a restaurant called The Phoenix that serves Fast food in the riverside area near Raja Indian Cuisine. It is not family-friendly and has a price range of less than £20.
"name[The Phoenix], eatType[restaurant], food[Fast food], priceRange[less than £20], area[riverside], familyFriendly[yes], near[Raja Indian Cuisine]"	The Phoenix is a family friendly restaurant that serves Fast food for less than £20. It is located near Raja Indian Cuisine in the riverside area.
"name[The Phoenix], eatType[restaurant], food[Fast food], priceRange[moderate], area[city centre], familyFriendly[no], near[Raja Indian Cuisine]"	In the city centre near Raja Indian Cuisine is a Fast food restaurant called The Phoenix. It is not kid friendly and has a moderate price range.
"name[The Phoenix], eatType[restaurant], food[Fast food], priceRange[moderate], area[city centre], familyFriendly[yes], near[Raja Indian Cuisine]"	The Phoenix is a moderately priced Fast food restaurant located in the city centre near Raja Indian Cuisine. It is kid friendly.
"name[The Phoenix], eatType[restaurant], food[Fast food], priceRange[moderate], area[riverside], familyFriendly[no], near[Raja Indian Cuisine]"	Near Raja Indian Cuisine is a restaurant called The Phoenix that serves Fast food at a moderate price range. It is not kid friendly.
"name[The Phoenix], eatType[restaurant], food[Fast food], priceRange[moderate], area[riverside], familyFriendly[yes], near[Raja Indian Cuisine]"	If you are looking for a moderately priced Fast food restaurant in the riverside area then the Phoenix is kid friendly.
"name[The Phoenix], eatType[restaurant], food[Fast food], priceRange[more than £30], area[riverside], familyFriendly[yes], near[Raja Indian Cuisine]"	The Phoenix is a restaurant that serves Fast food in the riverside area near Raja Indian Cuisine. It is child friendly and has a price range of more than £30.
"name[The Phoenix], eatType[restaurant], food[French], priceRange[£20-25], area[riverside], familyFriendly[yes], near[Raja Indian Cuisine]"	A kid friendly restaurant near Raja Indian Cuisine in the riverside area is The Phoenix. It serves French food and has a price range of £20-25.
"name[The Phoenix], eatType[restaurant], food[French], priceRange[cheap], area[riverside], familyFriendly[yes], near[Raja Indian Cuisine]"	There is a cheap restaurant The Phoenix located near Raja Indian Cuisine in the riverside area. It serves French food.
"name[The Phoenix], eatType[restaurant], food[French], priceRange[high], area[riverside], familyFriendly[yes], near[Raja Indian Cuisine]"	"Located near Raja Indian Cuisine in the riverside area, The Phoenix is a high priced restaurant that serves French food."
"name[The Phoenix], eatType[restaurant], food[Indian], priceRange[£20-25], customer rating[high], area[city centre], familyFriendly[no], near[Crowne Plaza Hotel]"	The Phoenix is a Indian restaurant with a high customer rating and a price range of £20-25. It is located in the city centre near Crowne Plaza Hotel.
"name[The Phoenix], eatType[restaurant], food[Indian], priceRange[£20-25], customer rating[high], area[city centre], familyFriendly[yes], near[Crowne Plaza Hotel]"	If you are looking for a kid friendly restaurant that serves Indian food in the £20-25 price range is The Phoenix. It is located in the city centre near Crowne Plaza Hotel.
"name[The Phoenix], eatType[restaurant], food[Indian], priceRange[£20-25], customer rating[high], area[riverside], familyFriendly[no], near[Crowne Plaza Hotel]"	"Located near Crowne Plaza Hotel in the riverside area, The Phoenix is a highly rated Indian restaurant with a price range of £20-25."
"name[The Phoenix], eatType[restaurant], food[Indian], priceRange[£20-25], customer rating[high], area[riverside], familyFriendly[yes], near[Crowne Plaza Hotel]"	The Phoenix is a restaurant that serves Indian food in the £20-25 price range. It is located in the riverside area near Crowne Plaza Hotel. It is kid friendly and has a high customer rating.
"name[The Phoenix], eatType[restaurant], food[Indian], priceRange[cheap], customer rating[5 out of 5], area[city centre], familyFriendly[no], near[Crowne Plaza Hotel]"	In the city centre near Crowne Plaza Hotel is a Indian restaurant called The Phoenix. It is not family-friendly and has a customer rating of 5 out of 5.
"name[The Phoenix], eatType[restaurant], food[Indian], priceRange[cheap], customer rating[5 out of 5], area[city centre], familyFriendly[yes], near[Crowne Plaza Hotel]"	The Phoenix is a cheap Indian restaurant located in the city centre near Crowne Plaza Hotel. It is family friendly and has a customer rating of 5 out of 5.
"name[The Phoenix], eatType[restaurant], food[Indian], priceRange[cheap], customer rating[5 out of 5], area[riverside], familyFriendly[no], near[Crowne Plaza Hotel]"	The Phoenix is a cheap restaurant that serves Indian food in the riverside area near Crowne Plaza Hotel. It is not family-friendly and has a customer rating of 5 out of 5.
"name[The Phoenix], eatType[restaurant], food[Indian], priceRange[cheap], customer rating[5 out of 5], area[riverside], familyFriendly[no], near[Express by Holiday Inn]"	There is a cheap restaurant The Phoenix located in the riverside area near Express by Holiday Inn. It is not family-friendly and has a 5 out of 5 customer rating.
"name[The Phoenix], eatType[restaurant], food[Indian], priceRange[cheap], customer rating[5 out of 5], area[riverside], familyFriendly[yes], near[Express by Holiday Inn]"	The Phoenix is a cheap restaurant that serves Indian food. It is located in the riverside area near Express by Holiday Inn. It is family friendly and has a customer rating of 5 out of 5.
"name[The Phoenix], eatType[restaurant], food[Indian], priceRange[cheap], customer rating[average], area[city centre], familyFriendly[no], near[Express by Holiday Inn]"	There is a cheap Indian restaurant near Express by Holiday Inn in the city centre called The Phoenix. It has an average customer rating and is not family-friendly.
"name[The Plough], eatType[pub], food[Chinese], priceRange[£20-25], area[riverside], familyFriendly[yes], near[Raja Indian Cuisine]"	If you are looking for a kid friendly pub near Raja Indian Cuisine in the riverside area then the Plough serves Chinese food with a price range of £20-25.
"name[The Plough], eatType[pub], food[Chinese], priceRange[cheap], area[riverside], familyFriendly[yes], near[Raja Indian Cuisine]"	If you are looking for a cheap pub that serves Chinese food in the riverside area then the Plough is family friendly. It is located near Raja Indian Cuisine.
"name[The Plough], eatType[pub], food[Chinese], priceRange[high], area[city centre], familyFriendly[no], near[Raja Indian Cuisine]"	For a high priced Chinese pub near Raja Indian Cuisine in the city centre there is The Plough. It is not child friendly.
"name[The Plough], eatType[pub], food[Chinese], priceRange[high], area[city centre], familyFriendly[yes], near[Raja Indian Cuisine]"	The Plough is a pub that serves Chinese food in the high price range. It is located in the city centre near Raja Indian Cuisine. It is children friendly.
"name[The Plough], eatType[pub], food[Chinese], priceRange[high], area[riverside], familyFriendly[no], near[Raja Indian Cuisine]"	The Plough is a pub that serves Chinese food in the high price range. It is located in the riverside area near Raja Indian Cuisine. It is not child friendly.
"name[The Plough], eatType[pub], food[Chinese], priceRange[high], area[riverside], familyFriendly[yes], near[Raja Indian Cuisine]"	If you are looking for a high priced pub that serves Chinese food in the riverside area is The Plough. It is child friendly and is located near Raja Indian Cuisine.
"name[The Plough], eatType[pub], food[Chinese], priceRange[less than £20], area[city centre], familyFriendly[no], near[Raja Indian Cuisine]"	"Located in the city centre near Raja Indian Cuisine, The Plough is a pub that serves Chinese food for less than £20. It is not family-friendly."
"name[The Plough], eatType[restaurant], food[Chinese], priceRange[£20-25], area[riverside], familyFriendly[yes], near[Raja Indian Cuisine]"	A kid friendly restaurant near Raja Indian Cuisine in the riverside area is The Plough. It serves Chinese food and has a price range of £20-25.
"name[The Plough], eatType[restaurant], food[Chinese], priceRange[cheap], area[riverside], familyFriendly[yes], near[Raja Indian Cuisine]"	A cheap restaurant in the riverside area near Raja Indian Cuisine is The Plough. It is family friendly.
"name[The Plough], eatType[restaurant], food[Chinese], priceRange[high], area[city centre], familyFriendly[no], near[Raja Indian Cuisine]"	The Plough is a high priced Chinese restaurant located in the city centre near Raja Indian Cuisine. It is not child friendly.
"name[The Plough], eatType[restaurant], food[Chinese], priceRange[high], area[city centre], familyFriendly[yes], near[Raja Indian Cuisine]"	A children friendly restaurant in the city centre near Raja Indian Cuisine is The Plough. It serves Chinese food and has a high price range.
"name[The Plough], eatType[restaurant], food[Chinese], priceRange[high], area[riverside], familyFriendly[no], near[Raja Indian Cuisine]"	At the riverside near Raja Indian Cuisine is a high priced Chinese restaurant called The Plough.
"name[The Plough], eatType[restaurant], food[Chinese], priceRange[high], area[riverside], familyFriendly[yes], near[Raja Indian Cuisine]"	"Located near Raja Indian Cuisine in the riverside area, The Plough is a high priced restaurant that serves Chinese food."
"name[The Plough], eatType[restaurant], food[Chinese], priceRange[less than £20], area[city centre], familyFriendly[no], near[Raja Indian Cuisine]"	Chinese restaurant The Plough is located in the city centre near Raja Indian Cuisine. It is not family-friendly and has a price range of less than £20.
"name[The Punter], eatType[pub], food[Chinese], priceRange[less than £20], area[city centre], familyFriendly[yes], near[Raja Indian Cuisine]"	The Punter is a family-friendly pub that serves Chinese food for less than £20. It is located in the city centre near Raja Indian Cuisine.
"name[The Punter], eatType[pub], food[Chinese], priceRange[less than £20], area[riverside], familyFriendly[no], near[Raja Indian Cuisine]"	"Located near Raja Indian Cuisine in the riverside area, The Punter is a pub that serves Chinese food for less than £20. It is not family-friendly."
"name[The Punter], eatType[pub], food[Chinese], priceRange[less than £20], area[riverside], familyFriendly[yes], near[Raja Indian Cuisine]"	In the riverside area near Raja Indian Cuisine is a pub called The Punter that serves Chinese food for less than £20. It is family friendly.
"name[The Punter], eatType[pub], food[Chinese], priceRange[moderate], area[city centre], familyFriendly[no], near[Raja Indian Cuisine]"	If you're looking for a moderately priced Chinese pub near Raja Indian Cuisine in the city centre there is The Punter. It is not kid friendly.
"name[The Punter], eatType[pub], food[Chinese], priceRange[moderate], area[city centre], familyFriendly[yes], near[Raja Indian Cuisine]"	The Punter is a pub that serves Chinese food in the moderate price range. It is located in the city centre near Raja Indian Cuisine. It is kid friendly.
"name[The Punter], eatType[pub], food[Chinese], priceRange[moderate], area[riverside], familyFriendly[no], near[Raja Indian Cuisine]"	There is a moderately priced pub near Raja Indian Cuisine in the riverside area that serves Chinese food called The Punter. It is not kid friendly.
"name[The Punter], eatType[pub], food[Chinese], priceRange[moderate], area[riverside], familyFriendly[yes], near[Raja Indian Cuisine]"	A kid friendly pub near Raja Indian Cuisine in the riverside area is The Punter. It serves Chinese food and has a moderate price range.
"name[The Punter], eatType[pub], food[Chinese], priceRange[more than £30], area[riverside], familyFriendly[yes], near[Raja Indian Cuisine]"	The Punter is a pub that serves Chinese food in the riverside area near Raja Indian Cuisine. It is child friendly and has a price range of more than £30.
"name[The Punter], eatType[pub], food[English], priceRange[£20-25], area[riverside], familyFriendly[yes], near[Raja Indian Cuisine]"	The Punter is a pub that serves English food in the riverside area near Raja Indian Cuisine. It is kid friendly and has a price range of £20-25.
"name[The Punter], eatType[pub], food[English], priceRange[cheap], area[riverside], familyFriendly[yes], near[Raja Indian Cuisine]"	Near Raja Indian Cuisine in the riverside area is a family friendly pub called The Punter. It serves English food and is cheap.
"name[The Punter], eatType[pub], food[English], priceRange[high], area[city centre], familyFriendly[no], near[Raja Indian Cuisine]"	The Punter is a pub that serves English food in the high price range. It is located in the city centre near Raja Indian Cuisine. It is not child friendly.
"name[The Punter], eatType[pub], food[English], priceRange[high], area[city centre], familyFriendly[yes], near[Raja Indian Cuisine]"	The Punter is a pub that serves English food in the high price range. It is located in the city centre near Raja Indian Cuisine. It is children friendly.
"name[The Punter], eatType[pub], food[English], priceRange[high], area[riverside], familyFriendly[no], near[Raja Indian Cuisine]"	The Punter is a pub that serves English food in the high price range. It is located in the riverside area near Raja Indian Cuisine. It is not child friendly.
"name[The Punter], eatType[pub], food[English], priceRange[high], area[riverside], familyFriendly[yes], near[Raja Indian Cuisine]"	If you are looking for a high priced pub that serves English food in the riverside area is The Punter. It is child friendly and is located near Raja Indian Cuisine.
"name[The Punter], eatType[pub], food[Italian], priceRange[high], customer rating[average], area[city centre], familyFriendly[no], near[Rainbow Vegetarian Café]"	There is a pub called The Punter that serves Italian food in the high price range. It is located in the city centre near Rainbow Vegetarian Café. It has an average customer rating and is not child friendly.
"name[The Punter], eatType[restaurant], food[Chinese], priceRange[less than £20], area[city centre], familyFriendly[yes], near[Raja Indian Cuisine]"	The Punter is a family-friendly restaurant that serves Chinese food for less than £20. It is located in the city centre near Raja Indian Cuisine.
"name[The Punter], eatType[restaurant], food[Chinese], priceRange[less than £20], area[riverside], familyFriendly[no], near[Raja Indian Cuisine]"	In the riverside area near Raja Indian Cuisine is a Chinese restaurant called The Punter. It is not family-friendly and has a price range of less than £20.
"name[The Punter], eatType[restaurant], food[Chinese], priceRange[less than £20], area[riverside], familyFriendly[yes], near[Raja Indian Cuisine]"	The Punter is a family friendly restaurant that serves Chinese food for less than £20. It is located in the riverside area near Raja Indian Cuisine.
"name[The Punter], eatType[restaurant], food[Chinese], priceRange[moderate], area[city centre], familyFriendly[no], near[Raja Indian Cuisine]"	Chinese restaurant The Punter is located in the city centre near Raja Indian Cuisine. It is not kid friendly and has a moderate price range.
"name[The Punter], eatType[restaurant], food[Chinese], priceRange[moderate], area[city centre], familyFriendly[yes], near[Raja Indian Cuisine]"	In the city centre near Raja Indian Cuisine is a Chinese restaurant called The Punter. It is kid friendly and has a moderate price range.
"name[The Punter], eatType[restaurant], food[Chinese], priceRange[moderate], area[riverside], familyFriendly[no], near[Raja Indian Cuisine]"	"If you are looking for a moderately priced Chinese restaurant in the riverside area near Raja Indian Cuisine, try The Punter."
"name[The Punter], eatType[restaurant], food[Chinese], priceRange[moderate], area[riverside], familyFriendly[yes], near[Raja Indian Cuisine]"	If you are looking for a moderately priced Chinese restaurant in the riverside area then the Punter is kid friendly.
"name[The Punter], eatType[restaurant], food[Chinese], priceRange[more than £30], area[riverside], familyFriendly[yes], near[Raja Indian Cuisine]"	The Punter is a restaurant that serves Chinese food in the riverside area near Raja Indian Cuisine. It is child friendly and has a price range of more than £30.
"name[The Punter], eatType[restaurant], food[English], priceRange[£20-25], area[riverside], familyFriendly[yes], near[Raja Indian Cuisine]"	A kid friendly restaurant near Raja Indian Cuisine in the riverside area is The Punter. It serves English food and has a price range of £20-25.
"name[The Punter], eatType[restaurant], food[English], priceRange[cheap], area[riverside], familyFriendly[yes], near[Raja Indian Cuisine]"	Near Raja Indian Cuisine is a cheap restaurant called The Punter that is family friendly.
"name[The Punter], eatType[restaurant], food[English], priceRange[high], area[city centre], familyFriendly[no], near[Raja Indian Cuisine]"	"If you are looking for a high priced English restaurant in the city centre near Raja Indian Cuisine, then The Punter is not child friendly."
"name[The Punter], eatType[restaurant], food[English], priceRange[high], area[city centre], familyFriendly[yes], near[Raja Indian Cuisine]"	There is a children friendly restaurant called The Punter that serves English food in the high price range. It is located in the city centre near Raja Indian Cuisine.
"name[The Punter], eatType[restaurant], food[English], priceRange[high], area[riverside], familyFriendly[no], near[Raja Indian Cuisine]"	There is a high priced restaurant The Punter located near Raja Indian Cuisine in the riverside area. It is not child friendly.
"name[The Punter], eatType[restaurant], food[English], priceRange[high], area[riverside], familyFriendly[yes], near[Raja Indian Cuisine]"	If you are looking for a high priced restaurant that is child friendly in the riverside area near Raja Indian Cuisine is The Punter.
"name[The Punter], eatType[restaurant], food[Indian], priceRange[cheap], customer rating[average], area[city centre], familyFriendly[yes], near[Express by Holiday Inn]"	If you are looking for a cheap Indian restaurant in the city centre there is a family friendly restaurant called The Punter. It has an average customer rating.
"name[The Punter], eatType[restaurant], food[Indian], priceRange[cheap], customer rating[average], area[riverside], familyFriendly[no], near[Express by Holiday Inn]"	In the riverside area near Express by Holiday Inn is a Indian restaurant called The Punter. It has an average customer rating and is not family-friendly.
"name[The Punter], eatType[restaurant], food[Indian], priceRange[cheap], customer rating[average], area[riverside], familyFriendly[yes], near[Express by Holiday Inn]"	The Punter is a cheap restaurant that serves Indian food. It is located in the riverside area near Express by Holiday Inn. It is family friendly and has an average customer rating.
"name[The Punter], eatType[restaurant], food[Indian], priceRange[high], customer rating[1 out of 5], area[city centre], familyFriendly[no], near[Express by Holiday Inn]"	The Punter is a high priced Indian restaurant located in the city centre near Express by Holiday Inn. It is not child friendly and has a customer rating of 1 out of 5.
"name[The Punter], eatType[restaurant], food[Indian], priceRange[high], customer rating[1 out of 5], area[city centre], familyFriendly[yes], near[Express by Holiday Inn]"	The Punter is a children friendly Indian restaurant with a high price range and a customer rating of 1 out of 5. It is located in the city centre near Express by Holiday Inn.
"name[The Punter], eatType[restaurant], food[Indian], priceRange[high], customer rating[1 out of 5], area[riverside], familyFriendly[no], near[Express by Holiday Inn]"	In the riverside area near Express by Holiday Inn is a high priced Indian restaurant called The Punter. It has a customer rating of 1 out of 5.
"name[The Punter], eatType[restaurant], food[Indian], priceRange[high], customer rating[1 out of 5], area[riverside], familyFriendly[yes], near[Express by Holiday Inn]"	The Punter is a high priced restaurant that serves Indian food. It is located in the riverside area near Express by Holiday Inn. It is child friendly and has a customer rating of 1 out of 5.
"name[The Punter], eatType[restaurant], food[Indian], priceRange[high], customer rating[average], area[city centre], familyFriendly[no], near[Express by Holiday Inn]"	There is a high priced Indian restaurant near Express by Holiday Inn in the city centre called The Punter. It has an average customer rating and is not child friendly.
"name[The Punter], eatType[restaurant], food[Indian], priceRange[high], customer rating[average], area[city centre], familyFriendly[yes], near[Express by Holiday Inn]"	The Punter is a children friendly Indian restaurant with an average customer rating and a high price range. It is located in the city centre near Express by Holiday Inn.
"name[The Punter], eatType[restaurant], food[Indian], priceRange[high], customer rating[average], area[riverside], familyFriendly[no], near[Express by Holiday Inn]"	Along the riverside near Express by Holiday Inn is a high priced Indian restaurant called The Punter. It has an average customer rating.
"name[The Punter], eatType[restaurant], food[Indian], priceRange[high], customer rating[average], area[riverside], familyFriendly[yes], near[Express by Holiday Inn]"	The Punter is a restaurant that serves Indian food in the high price range. It is located in the riverside area near Express by Holiday Inn. It has an average customer rating.
"name[The Punter], eatType[restaurant], food[Indian], priceRange[less than £20], customer rating[low], area[city centre], familyFriendly[no], near[Express by Holiday Inn]"	The Punter is a Indian restaurant located in the city centre near Express by Holiday Inn. It has a low customer rating and is not family-friendly.
"name[The Punter], eatType[restaurant], food[Indian], priceRange[less than £20], customer rating[low], area[city centre], familyFriendly[yes], near[Express by Holiday Inn]"	A family-friendly restaurant in the city centre near Express by Holiday Inn is The Punter. It has a low customer rating and serves Indian food.
"name[The Punter], eatType[restaurant], food[Indian], priceRange[less than £20], customer rating[low], area[riverside], familyFriendly[no], near[Express by Holiday Inn]"	The Punter is a restaurant that serves Indian food in the less than £20 price range. It is located in the riverside area near Express by Holiday Inn. It is not family-friendly.
"name[The Punter], eatType[restaurant], food[Indian], priceRange[less than £20], customer rating[low], area[riverside], familyFriendly[yes], near[Express by Holiday Inn]"	The Punter is a family friendly restaurant that serves Indian food for less than £20. It is located near Express by Holiday Inn in the riverside area.
"name[The Punter], eatType[restaurant], food[Indian], priceRange[moderate], customer rating[1 out of 5], area[city centre], familyFriendly[no], near[Express by Holiday Inn]"	The Punter is a moderately priced Indian restaurant located in the city centre near Express by Holiday Inn. It is not kid friendly and has a customer rating of 1 out of 5.
"name[The Punter], eatType[restaurant], food[Indian], priceRange[moderate], customer rating[1 out of 5], area[city centre], familyFriendly[yes], near[Express by Holiday Inn]"	The Punter is a moderately priced Indian restaurant located in the city centre near Express by Holiday Inn. It is kid friendly and has a customer rating of 1 out of 5.
"name[The Punter], eatType[restaurant], food[Indian], priceRange[moderate], customer rating[1 out of 5], area[riverside], familyFriendly[no], near[Express by Holiday Inn]"	The Punter is a moderately priced Indian restaurant located near Express by Holiday Inn in the riverside area. It is not kid friendly and has a customer rating of 1 out of 5.
"name[The Punter], eatType[restaurant], food[Indian], priceRange[moderate], customer rating[1 out of 5], area[riverside], familyFriendly[yes], near[Express by Holiday Inn]"	The Punter is a moderately priced Indian restaurant located near Express by Holiday Inn in the riverside area. It is kid friendly and has a customer rating of 1 out of 5.
"name[The Punter], eatType[restaurant], food[Indian], priceRange[moderate], customer rating[3 out of 5], area[city centre], familyFriendly[no], near[Express by Holiday Inn]"	There is a moderately priced Indian restaurant called The Punter located in the city centre near Express by Holiday Inn. It is not kid friendly and has a customer rating of 3 out of 5.
"name[The Punter], eatType[restaurant], food[Indian], priceRange[moderate], customer rating[3 out of 5], area[city centre], familyFriendly[yes], near[Express by Holiday Inn]"	The Punter is a moderately priced Indian restaurant located in the city centre near Express by Holiday Inn. It is kid friendly and has a customer rating of 3 out of 5.
"name[The Punter], eatType[restaurant], food[Indian], priceRange[moderate], customer rating[3 out of 5], area[riverside], familyFriendly[no], near[Express by Holiday Inn]"	The Punter is a restaurant that serves Indian food in the moderate price range. It is located in the riverside area near Express by Holiday Inn. It is not kid friendly.
"name[The Punter], eatType[restaurant], food[Indian], priceRange[moderate], customer rating[3 out of 5], area[riverside], familyFriendly[yes], near[Express by Holiday Inn]"	"Located near Express by Holiday Inn in the riverside area, The Punter is a kid friendly restaurant that serves Indian food at a moderate price range."
"name[The Punter], eatType[restaurant], food[Indian], priceRange[more than £30], customer rating[high], area[city centre], familyFriendly[no], near[Express by Holiday Inn]"	The Punter is a highly rated Indian restaurant in the city centre near Express by Holiday Inn. It is not child friendly and has a price range of more than £30.
"name[The Punter], eatType[restaurant], food[Indian], priceRange[more than £30], customer rating[high], area[city centre], familyFriendly[yes], near[Express by Holiday Inn]"	If you are looking for a highly rated Indian restaurant in the city centre there is a restaurant called The Punter. It is child friendly and is in the more than £30 price range.
"name[The Punter], eatType[restaurant], food[Indian], priceRange[more than £30], customer rating[high], area[riverside], familyFriendly[no], near[Express by Holiday Inn]"	The Punter is a highly rated Indian restaurant in the riverside area near Express by Holiday Inn. It is not child friendly and has a price range of more than £30.
"name[The Punter], eatType[restaurant], food[Indian], priceRange[more than £30], customer rating[high], area[riverside], familyFriendly[yes], near[Express by Holiday Inn]"	The Punter is a high rated restaurant that serves Indian food in the more than £30 price range. It is located in the riverside area near Express by Holiday Inn.
"name[The Punter], eatType[restaurant], food[Italian], priceRange[£20-25], customer rating[high], area[city centre], familyFriendly[no], near[Express by Holiday Inn]"	The Punter is a Italian restaurant with a high customer rating and a price range of £20-25. It is located in the city centre near Express by Holiday Inn.
"name[The Punter], eatType[restaurant], food[Italian], priceRange[£20-25], customer rating[high], area[city centre], familyFriendly[yes], near[Express by Holiday Inn]"	This restaurant The Punter is a family friendly Italian restaurant with a high customer rating and a price range of £20-25. It is located in the city centre near Express by Holiday Inn.
"name[The Punter], eatType[restaurant], food[Italian], priceRange[£20-25], customer rating[high], area[riverside], familyFriendly[no], near[Express by Holiday Inn]"	The Punter is a restaurant providing Italian food in the £20-25 price range. It is located in the riverside. It is near Express by Holiday Inn. Its customer rating is high.
"name[The Punter], eatType[restaurant], food[Italian], priceRange[£20-25], customer rating[high], area[riverside], familyFriendly[yes], near[Express by Holiday Inn]"	There is a restaurant called The Punter that serves Italian food in the £20-25 price range. It is located in the riverside area near Express by Holiday Inn. It is kid friendly and has a high customer rating.
"name[The Punter], eatType[restaurant], food[Italian], priceRange[cheap], customer rating[5 out of 5], area[city centre], familyFriendly[no], near[Express by Holiday Inn]"	There is a cheap Italian restaurant called The Punter located in the city centre near Express by Holiday Inn. It is not family-friendly and has a customer rating of 5 out of 5.
"name[The Punter], eatType[restaurant], food[Italian], priceRange[cheap], customer rating[5 out of 5], area[city centre], familyFriendly[no], near[Rainbow Vegetarian Café]"	The Punter is a cheap Italian restaurant located in the city centre near Rainbow Vegetarian Café. It is not family-friendly.
"name[The Punter], eatType[restaurant], food[Italian], priceRange[cheap], customer rating[5 out of 5], area[city centre], familyFriendly[yes], near[Rainbow Vegetarian Café]"	The Punter is a cheap Italian restaurant located in the city centre near Rainbow Vegetarian Café. It is family friendly and has a customer rating of 5 out of 5.
"name[The Punter], eatType[restaurant], food[Italian], priceRange[cheap], customer rating[5 out of 5], area[riverside], familyFriendly[no], near[Rainbow Vegetarian Café]"	In the riverside area near Rainbow Vegetarian Café is a Italian restaurant called The Punter. It has a customer rating of 5 out of 5 and is not family-friendly.
"name[The Punter], eatType[restaurant], food[Italian], priceRange[cheap], customer rating[5 out of 5], area[riverside], familyFriendly[yes], near[Rainbow Vegetarian Café]"	The Punter is a cheap restaurant that serves Italian food. It is located in the riverside area near Rainbow Vegetarian Café. It is family friendly and has a customer rating of 5 out of 5.
"name[The Punter], eatType[restaurant], food[Italian], priceRange[cheap], customer rating[average], area[city centre], familyFriendly[no], near[Rainbow Vegetarian Café]"	Near Rainbow Vegetarian Café in the city centre is a Italian restaurant called The Punter. It has an average customer rating and is not family-friendly.
"name[The Punter], eatType[restaurant], food[Italian], priceRange[cheap], customer rating[average], area[city centre], familyFriendly[yes], near[Rainbow Vegetarian Café]"	The Punter is a cheap Italian restaurant located in the city centre near Rainbow Vegetarian Café. It is family friendly and has an average customer rating.
"name[The Punter], eatType[restaurant], food[Italian], priceRange[cheap], customer rating[average], area[riverside], familyFriendly[no], near[Rainbow Vegetarian Café]"	The Punter is a cheap Italian restaurant located in the riverside area near Rainbow Vegetarian Café. It has an average customer rating.
"name[The Punter], eatType[restaurant], food[Italian], priceRange[cheap], customer rating[average], area[riverside], familyFriendly[yes], near[Rainbow Vegetarian Café]"	The Punter is a cheap restaurant that serves Italian food. It is located in the riverside area near Rainbow Vegetarian Café. It is family friendly and has an average customer rating.
"name[The Punter], eatType[restaurant], food[Italian], priceRange[high], customer rating[1 out of 5], area[city centre], familyFriendly[no], near[Rainbow Vegetarian Café]"	The Punter is a high priced Italian restaurant located in the city centre near Rainbow Vegetarian Café. It is not child friendly and has a customer rating of 1 out of 5.
"name[The Punter], eatType[restaurant], food[Italian], priceRange[high], customer rating[1 out of 5], area[city centre], familyFriendly[yes], near[Rainbow Vegetarian Café]"	The Punter is a high priced restaurant that serves Italian food. It is located in the city centre near Rainbow Vegetarian Café. It is child friendly and has a customer rating of 1 out of 5.
"name[The Punter], eatType[restaurant], food[Italian], priceRange[high], customer rating[1 out of 5], area[riverside], familyFriendly[no], near[Rainbow Vegetarian Café]"	"Along the riverside near Rainbow Vegetarian Café, there is a high priced Italian restaurant called The Punter. It has a customer rating of 1 out of 5."
"name[The Punter], eatType[restaurant], food[Italian], priceRange[high], customer rating[1 out of 5], area[riverside], familyFriendly[yes], near[Rainbow Vegetarian Café]"	At the riverside area is a high priced restaurant called The Punter. It is near Rainbow Vegetarian Café. It is child friendly and has a customer rating of 1 out of 5.
"name[The Vaults], eatType[pub], food[French], priceRange[high], area[riverside], familyFriendly[yes], near[Raja Indian Cuisine]"	If you are looking for a high priced pub that serves French food in the riverside area is The Vaults. It is child friendly and is located near Raja Indian Cuisine.
"name[The Vaults], eatType[pub], food[French], priceRange[less than £20], area[city centre], familyFriendly[no], near[Raja Indian Cuisine]"	The Vaults is a pub that serves French food for less than £20. It is located in the city centre near Raja Indian Cuisine. It is not family-friendly.
"name[The Vaults], eatType[pub], food[French], priceRange[less than £20], area[city centre], familyFriendly[yes], near[Raja Indian Cuisine]"	For a family-friendly pub serving French food in the city centre near Raja Indian Cuisine is The Vaults. It has a price range of less than £20.
"name[The Vaults], eatType[pub], food[French], priceRange[less than £20], area[riverside], familyFriendly[no], near[Raja Indian Cuisine]"	For a low priced pub that serves French food in the riverside area near Raja Indian Cuisine is The Vaults. It is not family-friendly.
"name[The Vaults], eatType[pub], food[French], priceRange[less than £20], area[riverside], familyFriendly[yes], near[Raja Indian Cuisine]"	In the riverside area near Raja Indian Cuisine is a pub called The Vaults that serves French food for less than £20. It is family friendly.
"name[The Vaults], eatType[pub], food[French], priceRange[moderate], area[city centre], familyFriendly[no], near[Raja Indian Cuisine]"	For a moderately priced French pub near Raja Indian Cuisine in the city centre there is The Vaults. It is not kid friendly.
"name[The Vaults], eatType[pub], food[French], priceRange[moderate], area[city centre], familyFriendly[yes], near[Raja Indian Cuisine]"	If you are looking for a kid friendly pub that serves French food in the city centre near Raja Indian Cuisine is The Vaults. It is moderately priced.
"name[The Vaults], eatType[pub], food[French], priceRange[moderate], area[riverside], familyFriendly[no], near[Raja Indian Cuisine]"	There is a moderately priced pub near Raja Indian Cuisine in the riverside area that serves French food called The Vaults. It is not kid friendly.
"name[The Vaults], eatType[pub], food[French], priceRange[moderate], area[riverside], familyFriendly[yes], near[Raja Indian Cuisine]"	If you are looking for a kid friendly pub that serves French food in the riverside area near Raja Indian Cuisine is The Vaults. It is moderately priced.
"name[The Vaults], eatType[pub], food[French], priceRange[more than £30], area[city centre], familyFriendly[no], near[Raja Indian Cuisine]"	The Vaults is a pub that serves French food in the more than £30 price range. It is located in the city centre near Raja Indian Cuisine. It is not child friendly.
"name[The Vaults], eatType[pub], food[French], priceRange[more than £30], area[city centre], familyFriendly[yes], near[Raja Indian Cuisine]"	There is a pub called The Vaults that serves French food in the city centre near Raja Indian Cuisine. It is child friendly and has a price range of more than £30.
"name[The Vaults], eatType[pub], food[French], priceRange[more than £30], area[riverside], familyFriendly[no], near[Raja Indian Cuisine]"	The Vaults is a pub that serves French food in the riverside area near Raja Indian Cuisine. It is not child friendly and has a price range of more than £30.
"name[The Vaults], eatType[pub], food[French], priceRange[more than £30], area[riverside], familyFriendly[yes], near[Raja Indian Cuisine]"	The Vaults is a pub that serves French food in the riverside area near Raja Indian Cuisine. It is child friendly and has a price range of more than £30.
"name[The Vaults], eatType[pub], food[Indian], priceRange[£20-25], area[riverside], familyFriendly[yes], near[Raja Indian Cuisine]"	There is a pub near Raja Indian Cuisine in the riverside area that serves Indian food called The Vaults. It is kid friendly and has a price range of £20-25.
"name[The Vaults], eatType[pub], food[Indian], priceRange[cheap], area[riverside], familyFriendly[yes], near[Raja Indian Cuisine]"	If you are looking for a cheap pub that serves Indian food in the riverside area then the Vaults is family friendly. It is located near Raja Indian Cuisine.
"name[The Vaults], eatType[pub], food[Indian], priceRange[high], area[city centre], familyFriendly[no], near[Raja Indian Cuisine]"	Indian food is served at The Vaults pub in the city centre near Raja Indian Cuisine. It is not child friendly and has a high price range.
"name[The Vaults], eatType[pub], food[Indian], priceRange[high], area[city centre], familyFriendly[yes], near[Raja Indian Cuisine]"	The Vaults is a pub that serves Indian food in the high price range. It is located in the city centre near Raja Indian Cuisine. It is children friendly.
"name[The Vaults], eatType[pub], food[Italian], priceRange[high], customer rating[average], area[city centre], familyFriendly[no], near[Rainbow Vegetarian Café]"	There is a pub called The Vaults that serves Italian food in the high price range. It is located in the city centre near Rainbow Vegetarian Café. It has an average customer rating and is not child friendly.
"name[The Vaults], eatType[pub], food[Italian], priceRange[high], customer rating[average], area[city centre], familyFriendly[yes], near[Rainbow Vegetarian Café]"	The Vaults is a pub that serves Italian food in the high price range. It is located in the city centre near Rainbow Vegetarian Café. It is children friendly and has an average customer rating.
"name[The Vaults], eatType[pub], food[Italian], priceRange[high], customer rating[average], area[riverside], familyFriendly[no], near[Rainbow Vegetarian Café]"	The Vaults is a pub that serves Italian food in the high price range. It is located in the riverside area near Rainbow Vegetarian Café. It has an average customer rating and is not child friendly.
"name[The Vaults], eatType[pub], food[Italian], priceRange[high], customer rating[average], area[riverside], familyFriendly[yes], near[Rainbow Vegetarian Café]"	The Vaults is a pub that serves Italian food in the high price range. It is located in the riverside area near Rainbow Vegetarian Café. It is children friendly and has an average customer rating.
"name[The Vaults], eatType[pub], food[Italian], priceRange[less than £20], customer rating[low], area[city centre], familyFriendly[no], near[Rainbow Vegetarian Café]"	The Vaults is a pub that serves Italian food for less than £20. It is located in the city centre near Rainbow Vegetarian Café. It is not family-friendly and has a low customer rating.
"name[The Vaults], eatType[pub], food[Italian], priceRange[less than £20], customer rating[low], area[city centre], familyFriendly[yes], near[Rainbow Vegetarian Café]"	A family-friendly pub near Rainbow Vegetarian Café in the city centre is The Vaults. It has a low customer rating and serves Italian food for less than £20.
"name[The Vaults], eatType[pub], food[Italian], priceRange[less than £20], customer rating[low], area[riverside], familyFriendly[no], near[Rainbow Vegetarian Café]"	The Vaults is a pub that serves Italian food in the less than £20 price range. It is located in the riverside area near Rainbow Vegetarian Café. It is not family-friendly and has a low customer rating.
"name[The Vaults], eatType[pub], food[Italian], priceRange[less than £20], customer rating[low], area[riverside], familyFriendly[yes], near[Rainbow Vegetarian Café]"	There is a family friendly pub called The Vaults that serves Italian food in the riverside area near Rainbow Vegetarian Café. It has a low customer rating and a price range of less than £20.
"name[The Vaults], eatType[pub], food[Italian], priceRange[moderate], customer rating[1 out of 5], area[city centre], familyFriendly[no], near[Rainbow Vegetarian Café]"	The Vaults is a moderately priced Italian pub located in the city centre near Rainbow Vegetarian Café. It is not kid friendly and has a customer rating of 1 out of 5.
"name[The Vaults], eatType[pub], food[Italian], priceRange[moderate], customer rating[1 out of 5], area[city centre], familyFriendly[yes], near[Rainbow Vegetarian Café]"	In the city centre near Rainbow Vegetarian Café is a pub called The Vaults that serves Italian food and is kid friendly. It has a moderate price range and a customer rating of 1 out of 5.
"name[The Vaults], eatType[pub], food[Italian], priceRange[moderate], customer rating[1 out of 5], area[riverside], familyFriendly[no], near[Rainbow Vegetarian Café]"	Near Rainbow Vegetarian Café in the riverside area is a pub called The Vaults that serves Italian food and is not kid friendly. It has a moderate price range and a customer rating of 1 out of 5.
"name[The Vaults], eatType[pub], food[Italian], priceRange[moderate], customer rating[1 out of 5], area[riverside], familyFriendly[yes], near[Rainbow Vegetarian Café]"	The Vaults is a pub that serves Italian food in the moderate price range. It is located in the riverside area near Rainbow Vegetarian Café. It is kid friendly and has a customer rating of 1 out of 5.
"name[The Vaults], eatType[pub], food[Italian], priceRange[moderate], customer rating[3 out of 5], area[city centre], familyFriendly[no], near[Rainbow Vegetarian Café]"	The Vaults is a moderately priced Italian pub located in the city centre near Rainbow Vegetarian Café. It is not kid friendly and has a customer rating of 3 out of 5.
"name[The Vaults], eatType[pub], food[Italian], priceRange[moderate], customer rating[3 out of 5], area[city centre], familyFriendly[yes], near[Rainbow Vegetarian Café]"	If you are looking for a kid friendly pub that serves Italian food in the city centre near Rainbow Vegetarian Café is The Vaults. It has a moderate price range and a customer rating of 3 out of 5.
"name[The Vaults], eatType[pub], food[Italian], priceRange[moderate], customer rating[3 out of 5], area[riverside], familyFriendly[no], near[Rainbow Vegetarian Café]"	In the riverside area near Rainbow Vegetarian Café is a pub called The Vaults. It serves Italian food and is not kid friendly. It has a moderate price range and a customer rating of 3 out of 5.
"name[The Vaults], eatType[pub], food[Italian], priceRange[moderate], customer rating[3 out of 5], area[riverside], familyFriendly[yes], near[Rainbow Vegetarian Café]"	The Vaults is a pub that serves Italian food in the moderate price range. It is located in the riverside area near Rainbow Vegetarian Café. It is kid friendly and has a customer rating of 3 out of 5.
"name[The Vaults], eatType[pub], food[Italian], priceRange[more than £30], customer rating[high], area[city centre], familyFriendly[no], near[Rainbow Vegetarian Café]"	The Vaults is a pub that serves Italian food in the more than £30 price range. It is located in the city centre near Rainbow Vegetarian Café. It is not child friendly and has a high customer rating.
"name[The Vaults], eatType[pub], food[Italian], priceRange[more than £30], customer rating[high], area[city centre], familyFriendly[yes], near[Rainbow Vegetarian Café]"	The Vaults is a pub that serves Italian food in the more than £30 price range. It is located in the city centre near Rainbow Vegetarian Café. It is child friendly and has a high customer rating.
"name[The Vaults], eatType[pub], food[Italian], priceRange[more than £30], customer rating[high], area[riverside], familyFriendly[no], near[Rainbow Vegetarian Café]"	In the riverside area near Rainbow Vegetarian Café is a pub called The Vaults. It serves Italian food and is not child friendly. The price range is more than £30.
"name[The Vaults], eatType[pub], food[Italian], priceRange[more than £30], customer rating[high], area[riverside], familyFriendly[yes], near[Rainbow Vegetarian Café]"	Rainbow Vegetarian Café is a high rated Italian pub near Rainbow Vegetarian Café in the riverside area that is child friendly and has a price range of more than £30.
"name[The Vaults], eatType[pub], food[Japanese], priceRange[£20-25], customer rating[3 out of 5], area[city centre], familyFriendly[no], near[Rainbow Vegetarian Café]"	"Located in the city centre near Rainbow Vegetarian Café, The Vaults is a Japanese pub with a price range of £20-25. It is not kid friendly and has a customer rating of 3 out of 5."
"name[The Vaults], eatType[pub], food[Japanese], priceRange[£20-25], customer rating[3 out of 5], area[city centre], familyFriendly[yes], near[Rainbow Vegetarian Café]"	The Vaults is a pub that serves Japanese food in the £20-25 price range. It is located in the city centre near Rainbow Vegetarian Café. It is kid friendly and has a customer rating of 3 out of 5.
"name[The Vaults], eatType[pub], food[Japanese], priceRange[£20-25], customer rating[3 out of 5], area[riverside], familyFriendly[no], near[Rainbow Vegetarian Café]"	"Located near Rainbow Vegetarian Café in the riverside area, The Vaults is a Japanese pub with a price range of £20-25. It is not kid friendly and has a customer rating of 3 out of 5."
"name[The Vaults], eatType[pub], food[Japanese], priceRange[£20-25], customer rating[3 out of 5], area[riverside], familyFriendly[yes], near[Rainbow Vegetarian Café]"	"Located near Rainbow Vegetarian Café in the riverside area, The Vaults is a kid friendly pub with a customer rating of 3 out of 5. It serves Japanese food and is in the £20-25 price range."
"name[The Vaults], eatType[pub], food[Japanese], priceRange[£20-25], customer rating[high], area[city centre], familyFriendly[no], near[Rainbow Vegetarian Café]"	There is a pub called The Vaults that serves Japanese food in the £20-25 price range. It is located in the city centre near Rainbow Vegetarian Café. It has a high customer rating and is not kid friendly.
"name[The Vaults], eatType[pub], food[Japanese], priceRange[£20-25], customer rating[high], area[city centre], familyFriendly[yes], near[Rainbow Vegetarian Café]"	A highly rated Japanese pub near Rainbow Vegetarian Café in the city centre is The Vaults. It is kid friendly and has a price range of £20-25.
"name[The Vaults], eatType[pub], food[Japanese], priceRange[£20-25], customer rating[high], area[riverside], familyFriendly[no], near[Rainbow Vegetarian Café]"	The Vaults is a pub that serves Japanese food in the £20-25 price range. It is located in the riverside area near Rainbow Vegetarian Café. It has a high customer rating and is not kid friendly.
"name[The Vaults], eatType[pub], food[Japanese], priceRange[£20-25], customer rating[high], area[riverside], familyFriendly[no], near[Raja Indian Cuisine]"	"Located near Raja Indian Cuisine in the riverside area, The Vaults is a pub that serves Japanese food with a price range of £20-25. It is not kid friendly and has a high customer rating."
"name[The Vaults], eatType[pub], food[Japanese], priceRange[£20-25], customer rating[high], area[riverside], familyFriendly[yes], near[Raja Indian Cuisine]"	The Vaults is a pub that serves Japanese food in the £20-25 price range. It is located in the riverside area near Raja Indian Cuisine. It is kid friendly and has a high customer rating.
"name[The Vaults], eatType[pub], food[Japanese], priceRange[cheap], customer rating[5 out of 5], area[city centre], familyFriendly[no], near[Raja Indian Cuisine]"	The Vaults is a cheap Japanese pub located in the city centre near Raja Indian Cuisine. It has a customer rating of 5 out of 5 and is not family-friendly.
"name[The Vaults], eatType[pub], food[Japanese], priceRange[cheap], customer rating[5 out of 5], area[city centre], familyFriendly[yes], near[Raja Indian Cuisine]"	The Vaults is a cheap Japanese pub located in the city centre near Raja Indian Cuisine. It is family friendly and has a customer rating of 5 out of 5.
"name[The Vaults], eatType[pub], food[Japanese], priceRange[cheap], customer rating[5 out of 5], area[riverside], familyFriendly[no], near[Raja Indian Cuisine]"	The Vaults is a cheap Japanese pub located in the riverside area near Raja Indian Cuisine. It is not family-friendly and has a customer rating of 5 out of 5.
"name[The Vaults], eatType[pub], food[Japanese], priceRange[cheap], customer rating[5 out of 5], area[riverside], familyFriendly[yes], near[Raja Indian Cuisine]"	There is a cheap pub named The Vaults that serves Japanese food in the riverside area near Raja Indian Cuisine. It is family friendly and has a customer rating of 5 out of 5.
"name[The Vaults], eatType[pub], food[Japanese], priceRange[high], customer rating[3 out of 5], area[city centre], familyFriendly[no], near[Raja Indian Cuisine]"	The Vaults is a pub that serves Japanese food in the city centre near Raja Indian Cuisine. It has a high price range and a customer rating of 3 out of 5. It is not child friendly.
"name[The Vaults], eatType[pub], food[Japanese], priceRange[high], customer rating[3 out of 5], area[city centre], familyFriendly[yes], near[Raja Indian Cuisine]"	The Vaults is a pub that serves Japanese food in the high price range. It is located in the city centre near Raja Indian Cuisine. It is child friendly and has a customer rating of 3 out of 5.
"name[The Vaults], eatType[pub], food[Japanese], priceRange[high], customer rating[3 out of 5], area[riverside], familyFriendly[no], near[Raja Indian Cuisine]"	The Vaults is a pub that serves Japanese food in the riverside area near Raja Indian Cuisine. It has a high price range and a customer rating of 3 out of 5. It is not child friendly.
"name[The Vaults], eatType[pub], food[Japanese], priceRange[high], customer rating[3 out of 5], area[riverside], familyFriendly[yes], near[Raja Indian Cuisine]"	The Vaults is a pub that serves Japanese food in the high price range. It is located in the riverside area near Raja Indian Cuisine. It is child friendly and has a customer rating of 3 out of 5.
"name[The Vaults], eatType[pub], food[Japanese], priceRange[less than £20], customer rating[average], area[city centre], familyFriendly[no], near[Raja Indian Cuisine]"	Near Raja Indian Cuisine in the city centre is a pub called The Vaults that serves Japanese food for less than £20. It is not family-friendly and has an average customer rating.
"name[The Vaults], eatType[pub], food[Japanese], priceRange[less than £20], customer rating[average], area[city centre], familyFriendly[yes], near[Raja Indian Cuisine]"	A family-friendly pub near Raja Indian Cuisine in the city centre is The Vaults. It has an average customer rating and serves Japanese food for less than £20.
"name[The Vaults], eatType[pub], food[Japanese], priceRange[less than £20], customer rating[average], area[riverside], familyFriendly[no], near[Raja Indian Cuisine]"	Near Raja Indian Cuisine in the riverside area is a pub called The Vaults that serves Japanese food for less than £20. It is not family-friendly and has an average customer rating.
"name[The Vaults], eatType[pub], food[Japanese], priceRange[less than £20], customer rating[average], area[riverside], familyFriendly[yes], near[Raja Indian Cuisine]"	In the riverside area near Raja Indian Cuisine is a family friendly pub called The Vaults. It serves Japanese food and has an average customer rating.
"name[The Vaults], eatType[pub], food[Japanese], priceRange[less than £20], customer rating[low], area[city centre], familyFriendly[no], near[Raja Indian Cuisine]"	Near Raja Indian Cuisine in the city centre is a pub called The Vaults. It serves Japanese food and is not family-friendly. It has a low customer rating and a price range of less than £20.
"name[The Vaults], eatType[pub], food[Japanese], priceRange[less than £20], customer rating[low], area[city centre], familyFriendly[yes], near[Raja Indian Cuisine]"	There is a family-friendly pub called The Vaults that serves Japanese food in the city centre near Raja Indian Cuisine. It has a low customer rating and a price range of less than £20.
"name[The Vaults], eatType[pub], food[Japanese], priceRange[less than £20], customer rating[low], area[riverside], familyFriendly[no], near[Raja Indian Cuisine]"	The Vaults is a pub that serves Japanese food in the less than £20 price range. It is located in the riverside area near Raja Indian Cuisine. It is not family-friendly and has a low customer rating.
"name[The Vaults], eatType[pub], food[Japanese], priceRange[less than £20], customer rating[low], area[riverside], familyFriendly[yes], near[Raja Indian Cuisine]"	There is a family friendly pub called The Vaults that serves Japanese food in the riverside area near Raja Indian Cuisine. It has a low customer rating and a price range of less than £20.
"name[The Vaults], eatType[pub], food[Japanese], priceRange[moderate], customer rating[1 out of 5], area[city centre], familyFriendly[no], near[Raja Indian Cuisine]"	Near Raja Indian Cuisine in the city centre is a pub called The Vaults that serves Japanese food at a moderate price range. It is not kid friendly and has a customer rating of 1 out of 5.
"name[The Vaults], eatType[pub], food[Japanese], priceRange[moderate], customer rating[1 out of 5], area[city centre], familyFriendly[yes], near[Raja Indian Cuisine]"	The Vaults is a pub that serves Japanese food in the moderate price range. It is located in the city centre near Raja Indian Cuisine. It is kid friendly and has a customer rating of 1 out of 5.
"name[The Vaults], eatType[restaurant], food[French], priceRange[high], area[riverside], familyFriendly[yes], near[Raja Indian Cuisine]"	If you are looking for a high priced restaurant that is child friendly in the riverside area near Raja Indian Cuisine is The Vaults.
"name[The Vaults], eatType[restaurant], food[French], priceRange[less than £20], area[city centre], familyFriendly[no], near[Raja Indian Cuisine]"	"Located in the city centre near Raja Indian Cuisine, The Vaults is a French restaurant with a price range of less than £20."
"name[The Vaults], eatType[restaurant], food[French], priceRange[less than £20], area[city centre], familyFriendly[yes], near[Raja Indian Cuisine]"	The Vaults is a family-friendly restaurant that serves French food for less than £20. It is located in the city centre near Raja Indian Cuisine.
"name[The Vaults], eatType[restaurant], food[French], priceRange[less than £20], area[riverside], familyFriendly[no], near[Raja Indian Cuisine]"	"Located near Raja Indian Cuisine in the riverside area, The Vaults is a French restaurant with a price range of less than £20."
"name[The Vaults], eatType[restaurant], food[French], priceRange[less than £20], area[riverside], familyFriendly[yes], near[Raja Indian Cuisine]"	The Vaults is a family friendly restaurant that serves French food for less than £20. It is located near Raja Indian Cuisine in the riverside area.
"name[The Vaults], eatType[restaurant], food[French], priceRange[moderate], area[city centre], familyFriendly[no], near[Raja Indian Cuisine]"	In the city centre near Raja Indian Cuisine is a French restaurant called The Vaults. It is not kid friendly and has a moderate price range.
"name[The Vaults], eatType[restaurant], food[French], priceRange[moderate], area[city centre], familyFriendly[yes], near[Raja Indian Cuisine]"	"Located in the city centre near Raja Indian Cuisine, The Vaults is a kid friendly restaurant that serves French food at a moderate price."
"name[The Vaults], eatType[restaurant], food[French], priceRange[moderate], area[riverside], familyFriendly[no], near[Raja Indian Cuisine]"	Near Raja Indian Cuisine is a restaurant called The Vaults that serves French food at a moderate price range. It is not kid friendly.
"name[The Vaults], eatType[restaurant], food[French], priceRange[moderate], area[riverside], familyFriendly[yes], near[Raja Indian Cuisine]"	"Located near Raja Indian Cuisine in the riverside area, The Vaults is a kid friendly restaurant that serves French food at a moderate price."
"name[The Vaults], eatType[restaurant], food[French], priceRange[more than £30], area[city centre], familyFriendly[no], near[Raja Indian Cuisine]"	The Vaults is a French restaurant located in the city centre near Raja Indian Cuisine. It is not child friendly and has a price range of more than £30.
"name[The Vaults], eatType[restaurant], food[French], priceRange[more than £30], area[city centre], familyFriendly[yes], near[Raja Indian Cuisine]"	The Vaults is a children friendly restaurant that serves French food in the more than £30 price range. It is located in the city centre near Raja Indian Cuisine.
"name[The Vaults], eatType[restaurant], food[French], priceRange[more than £30], area[riverside], familyFriendly[no], near[Raja Indian Cuisine]"	In the riverside area near Raja Indian Cuisine is a French restaurant called The Vaults. It is not child friendly and has a price range of more than £30.
"name[The Vaults], eatType[restaurant], food[French], priceRange[more than £30], area[riverside], familyFriendly[yes], near[Raja Indian Cuisine]"	The Vaults is a restaurant that serves French food in the riverside area near Raja Indian Cuisine. It is child friendly and has a price range of more than £30.
"name[The Vaults], eatType[restaurant], food[Indian], priceRange[£20-25], area[riverside], familyFriendly[yes], near[Raja Indian Cuisine]"	If you are looking for a kid friendly restaurant that serves Indian food in the riverside area near Raja Indian Cuisine is The Vaults.
"name[The Vaults], eatType[restaurant], food[Indian], priceRange[cheap], area[riverside], familyFriendly[yes], near[Raja Indian Cuisine]"	A cheap restaurant in the riverside area near Raja Indian Cuisine is The Vaults. It is family friendly.
"name[The Vaults], eatType[restaurant], food[Indian], priceRange[high], area[city centre], familyFriendly[no], near[Raja Indian Cuisine]"	There is a high priced Indian restaurant near Raja Indian Cuisine in the city centre called The Vaults. It is not child friendly.
"name[The Vaults], eatType[restaurant], food[Indian], priceRange[high], area[city centre], familyFriendly[yes], near[Raja Indian Cuisine]"	A children friendly restaurant in the city centre near Raja Indian Cuisine is The Vaults. It serves Indian food and has a high price range.
"name[The Waterman], eatType[pub], food[Indian], priceRange[high], area[city centre], familyFriendly[yes], near[Raja Indian Cuisine]"	The Waterman is a pub that serves Indian food in the high price range. It is located in the city centre near Raja Indian Cuisine. It is children friendly.
"name[The Waterman], eatType[pub], food[Indian], priceRange[high], area[riverside], familyFriendly[no], near[Raja Indian Cuisine]"	The Waterman is a pub that serves Indian food in the high price range. It is located in the riverside area near Raja Indian Cuisine. It is not child friendly.
"name[The Waterman], eatType[pub], food[Indian], priceRange[high], area[riverside], familyFriendly[yes], near[Raja Indian Cuisine]"	If you are looking for a high priced pub that serves Indian food in the riverside area is The Waterman. It is child friendly and is located near Raja Indian Cuisine.
"name[The Waterman], eatType[pub], food[Indian], priceRange[less than £20], area[city centre], familyFriendly[no], near[Raja Indian Cuisine]"	Indian food is served at The Waterman pub in the city centre near Raja Indian Cuisine. It is not family-friendly and has a price range of less than £20.
"name[The Waterman], eatType[pub], food[Indian], priceRange[less than £20], area[city centre], familyFriendly[yes], near[Raja Indian Cuisine]"	For a family-friendly pub serving Indian food in the city centre near Raja Indian Cuisine is The Waterman. It has a price range of less than £20.
"name[The Waterman], eatType[pub], food[Indian], priceRange[less than £20], area[riverside], familyFriendly[no], near[Raja Indian Cuisine]"	There is a pub called The Waterman that serves Indian food in the riverside area near Raja Indian Cuisine. It is not family-friendly and has a price range of less than £20.
"name[The Waterman], eatType[pub], food[Indian], priceRange[less than £20], area[riverside], familyFriendly[yes], near[Raja Indian Cuisine]"	Near Raja Indian Cuisine in the riverside area is a pub called The Waterman that serves Indian food for less than £20. It is family friendly.
"name[The Waterman], eatType[pub], food[Indian], priceRange[moderate], area[city centre], familyFriendly[no], near[Raja Indian Cuisine]"	For a moderately priced Indian pub near Raja Indian Cuisine in the city centre there is The Waterman. It is not kid friendly.
"name[The Waterman], eatType[pub], food[Indian], priceRange[moderate], area[city centre], familyFriendly[yes], near[Raja Indian Cuisine]"	The Waterman is a pub that serves Indian food in the moderate price range. It is located in the city centre near Raja Indian Cuisine. It is kid friendly.
"name[The Waterman], eatType[pub], food[Indian], priceRange[moderate], area[riverside], familyFriendly[no], near[Raja Indian Cuisine]"	There is a moderately priced pub near Raja Indian Cuisine in the riverside area that serves Indian food called The Waterman. It is not kid friendly.
"name[The Waterman], eatType[pub], food[Indian], priceRange[moderate], area[riverside], familyFriendly[yes], near[Raja Indian Cuisine]"	"Located near Raja Indian Cuisine in the riverside area, The Waterman is a kid friendly pub that serves Indian food at a moderate price."
"name[The Waterman], eatType[pub], food[Indian], priceRange[more than £30], area[riverside], familyFriendly[yes], near[Raja Indian Cuisine]"	The Waterman is a pub that serves Indian food in the riverside area near Raja Indian Cuisine. It is child friendly and has a price range of more than £30.
"name[The Waterman], eatType[pub], food[Italian], priceRange[£20-25], area[riverside], familyFriendly[yes], near[Raja Indian Cuisine]"	If you are looking for a kid friendly pub near Raja Indian Cuisine in the riverside area then the Waterman serves Italian food with a price range of £20-25.
"name[The Waterman], eatType[pub], food[Italian], priceRange[cheap], area[riverside], familyFriendly[yes], near[Raja Indian Cuisine]"	If you are looking for a cheap pub that serves Italian food in the riverside area then the Waterman is family friendly. It is located near Raja Indian Cuisine.
"name[The Waterman], eatType[pub], food[Italian], priceRange[high], area[city centre], familyFriendly[no], near[Raja Indian Cuisine]"	The Waterman is a pub that serves Italian food in the high price range. It is located in the city centre near Raja Indian Cuisine. It is not child friendly.
"name[The Waterman], eatType[pub], food[Italian], priceRange[high], area[city centre], familyFriendly[yes], near[Raja Indian Cuisine]"	The Waterman is a pub that serves Italian food in the high price range. It is located in the city centre near Raja Indian Cuisine. It is children friendly.
"name[The Waterman], eatType[pub], food[Italian], priceRange[high], area[riverside], familyFriendly[no], near[Raja Indian Cuisine]"	The Waterman is a pub that serves Italian food in the high price range. It is located in the riverside area near Raja Indian Cuisine. It is not child friendly.
"name[The Waterman], eatType[pub], food[Italian], priceRange[high], area[riverside], familyFriendly[yes], near[Raja Indian Cuisine]"	If you are looking for a high priced pub that serves Italian food in the riverside area is The Waterman. It is child friendly and is located near Raja Indian Cuisine.
"name[The Waterman], eatType[pub], food[Italian], priceRange[less than £20], area[city centre], familyFriendly[no], near[Raja Indian Cuisine]"	There is a pub called The Waterman that serves Italian food in the city centre near Raja Indian Cuisine. It is not family-friendly and has a price range of less than £20.
"name[The Waterman], eatType[pub], food[Italian], priceRange[less than £20], area[city centre], familyFriendly[yes], near[Raja Indian Cuisine]"	In the city centre near Raja Indian Cuisine is a pub called The Waterman that serves Italian food for less than £20. It is family friendly.
"name[The Waterman], eatType[pub], food[Italian], priceRange[less than £20], area[riverside], familyFriendly[no], near[Raja Indian Cuisine]"	The Waterman is a pub that serves Italian food for less than £20. It is located in the riverside area near Raja Indian Cuisine. It is not family-friendly.
"name[The Waterman], eatType[restaurant], food[Indian], priceRange[high], area[city centre], familyFriendly[yes], near[Raja Indian Cuisine]"	The Waterman is a children friendly Indian restaurant in the city centre near Raja Indian Cuisine. It has a high price range.
"name[The Waterman], eatType[restaurant], food[Indian], priceRange[high], area[riverside], familyFriendly[no], near[Raja Indian Cuisine]"	"Located in the riverside area, The Waterman is a high priced Indian restaurant near Raja Indian Cuisine."
"name[The Waterman], eatType[restaurant], food[Indian], priceRange[high], area[riverside], familyFriendly[yes], near[Raja Indian Cuisine]"	A restaurant near Raja Indian Cuisine in the riverside area is The Waterman. It is child friendly and serves Indian food.
"name[The Waterman], eatType[restaurant], food[Indian], priceRange[less than £20], area[city centre], familyFriendly[no], near[Raja Indian Cuisine]"	Near Raja Indian Cuisine is a Indian restaurant called The Waterman. It is not family-friendly and has a price range of less than £20.
"name[The Waterman], eatType[restaurant], food[Indian], priceRange[less than £20], area[city centre], familyFriendly[yes], near[Raja Indian Cuisine]"	The Waterman is a family-friendly restaurant that serves Indian food for less than £20. It is located in the city centre near Raja Indian Cuisine.
"name[The Waterman], eatType[restaurant], food[Indian], priceRange[less than £20], area[riverside], familyFriendly[no], near[Raja Indian Cuisine]"	"Located near Raja Indian Cuisine in the riverside area, The Waterman is a Indian restaurant with a price range of less than £20."
"name[The Waterman], eatType[restaurant], food[Indian], priceRange[less than £20], area[riverside], familyFriendly[yes], near[Raja Indian Cuisine]"	The Waterman is a family friendly restaurant that serves Indian food for less than £20. It is located near Raja Indian Cuisine in the riverside area.
"name[The Waterman], eatType[restaurant], food[Indian], priceRange[moderate], area[city centre], familyFriendly[no], near[Raja Indian Cuisine]"	Near Raja Indian Cuisine in the city centre is a Indian restaurant called The Waterman. It is not kid friendly and has a moderate price range.
"name[The Waterman], eatType[restaurant], food[Indian], priceRange[moderate], area[city centre], familyFriendly[yes], near[Raja Indian Cuisine]"	The Waterman is a moderately priced Indian restaurant located in the city centre near Raja Indian Cuisine. It is kid friendly.
"name[The Waterman], eatType[restaurant], food[Indian], priceRange[moderate], area[riverside], familyFriendly[no], near[Raja Indian Cuisine]"	The Waterman is a restaurant that serves Indian food in the moderate price range. It is located in the riverside area near Raja Indian Cuisine.
"name[The Waterman], eatType[restaurant], food[Indian], priceRange[moderate], area[riverside], familyFriendly[yes], near[Raja Indian Cuisine]"	A restaurant near Raja Indian Cuisine in the riverside area is The Waterman. It is kid friendly and serves Indian food.
"name[The Waterman], eatType[restaurant], food[Indian], priceRange[more than £30], area[riverside], familyFriendly[yes], near[Raja Indian Cuisine]"	The Waterman is a restaurant that serves Indian food in the riverside area near Raja Indian Cuisine. It is child friendly and has a price range of more than £30.
"name[The Waterman], eatType[restaurant], food[Italian], priceRange[£20-25], area[riverside], familyFriendly[yes], near[Raja Indian Cuisine]"	There is a kid friendly restaurant near Raja Indian Cuisine in the riverside area called The Waterman. It serves Italian food and has a price range of £20-25.
"name[The Waterman], eatType[restaurant], food[Italian], priceRange[cheap], area[riverside], familyFriendly[yes], near[Raja Indian Cuisine]"	Near Raja Indian Cuisine is a cheap restaurant called The Waterman that is family friendly.
"name[The Waterman], eatType[restaurant], food[Italian], priceRange[high], area[city centre], familyFriendly[no], near[Raja Indian Cuisine]"	There is a high priced Italian restaurant near Raja Indian Cuisine in the city centre called The Waterman. It is not child friendly.
"name[The Waterman], eatType[restaurant], food[Italian], priceRange[high], area[city centre], familyFriendly[yes], near[Raja Indian Cuisine]"	There is a children friendly restaurant called The Waterman that serves Italian food in the high price range. It is located in the city centre near Raja Indian Cuisine.
"name[The Waterman], eatType[restaurant], food[Italian], priceRange[high], area[riverside], familyFriendly[no], near[Raja Indian Cuisine]"	There is a high priced restaurant The Waterman located near Raja Indian Cuisine in the riverside area. It is not child friendly.
"name[The Waterman], eatType[restaurant], food[Italian], priceRange[high], area[riverside], familyFriendly[yes], near[Raja Indian Cuisine]"	"Located near Raja Indian Cuisine in the riverside area, The Waterman is a high priced restaurant that serves Italian food."
"name[The Waterman], eatType[restaurant], food[Italian], priceRange[less than £20], area[city centre], familyFriendly[no], near[Raja Indian Cuisine]"	Italian restaurant The Waterman is located in the city centre near Raja Indian Cuisine. It is not family-friendly and has a price range of less than £20.
"name[The Waterman], eatType[restaurant], food[Italian], priceRange[less than £20], area[city centre], familyFriendly[yes], near[Raja Indian Cuisine]"	The Waterman is a family-friendly restaurant that serves Italian food for less than £20. It is located in the city centre near Raja Indian Cuisine.
"name[The Waterman], eatType[restaurant], food[Italian], priceRange[less than £20], area[riverside], familyFriendly[no], near[Raja Indian Cuisine]"	In the riverside area near Raja Indian Cuisine is a Italian restaurant called The Waterman. It is not family-friendly and has a price range of less than £20.
"name[The Wrestlers], eatType[pub], food[Italian], priceRange[less than £20], area[riverside], familyFriendly[no], near[Raja Indian Cuisine]"	"Located near Raja Indian Cuisine in the riverside area, The Wrestlers is a pub that serves Italian food for less than £20. It is not family-friendly."
"name[The Wrestlers], eatType[pub], food[Italian], priceRange[less than £20], area[riverside], familyFriendly[yes], near[Raja Indian Cuisine]"	"Located near Raja Indian Cuisine in the riverside area, The Wrestlers is a family friendly pub that serves Italian food for less than £20."
"name[The Wrestlers], eatType[pub], food[Italian], priceRange[moderate], area[city centre], familyFriendly[no], near[Raja Indian Cuisine]"	An Italian pub near Raja Indian Cuisine in the city centre is The Wrestlers. It is not kid friendly and has a moderate price range.
"name[The Wrestlers], eatType[pub], food[Italian], priceRange[moderate], area[city centre], familyFriendly[yes], near[Raja Indian Cuisine]"	There is a moderately priced pub The Wrestlers located in the city centre near Raja Indian Cuisine. It serves Italian food and is kid friendly.
"name[The Wrestlers], eatType[pub], food[Italian], priceRange[moderate], area[riverside], familyFriendly[no], near[Raja Indian Cuisine]"	The Wrestlers is a pub that serves Italian food in the moderate price range. It is located in the riverside area near Raja Indian Cuisine. It is not kid friendly.
"name[The Wrestlers], eatType[pub], food[Italian], priceRange[moderate], area[riverside], familyFriendly[yes], near[Raja Indian Cuisine]"	"Located near Raja Indian Cuisine in the riverside area, The Wrestlers is a kid friendly pub that serves Italian food at a moderate price."
"name[The Wrestlers], eatType[pub], food[Italian], priceRange[more than £30], area[riverside], familyFriendly[yes], near[Raja Indian Cuisine]"	There is a pub called The Wrestlers that serves Italian food in the riverside area near Raja Indian Cuisine. It is child friendly and has a price range of more than £30.
"name[The Wrestlers], eatType[pub], food[Japanese], priceRange[£20-25], area[riverside], familyFriendly[yes], near[Raja Indian Cuisine]"	A kid friendly pub near Raja Indian Cuisine in the riverside area is The Wrestlers. It serves Japanese food and has a price range of £20-25.
"name[The Wrestlers], eatType[pub], food[Japanese], priceRange[cheap], area[riverside], familyFriendly[yes], near[Raja Indian Cuisine]"	If you are looking for a cheap pub that serves Japanese food in the riverside area then the Wrestlers is family friendly. It is located near Raja Indian Cuisine.
"name[The Wrestlers], eatType[pub], food[Japanese], priceRange[high], area[riverside], familyFriendly[yes], near[Raja Indian Cuisine]"	If you are looking for a high priced pub that serves Japanese food in the riverside area is The Wrestlers. It is child friendly and is located near Raja Indian Cuisine.
"name[The Wrestlers], eatType[pub], food[Japanese], priceRange[less than £20], area[city centre], familyFriendly[no], near[Raja Indian Cuisine]"	The Wrestlers is a pub that serves Japanese food for less than £20. It is located in the city centre near Raja Indian Cuisine. It is not family-friendly.
"name[The Wrestlers], eatType[pub], food[Japanese], priceRange[less than £20], area[city centre], familyFriendly[yes], near[Raja Indian Cuisine]"	If you are looking for a family-friendly pub that serves Japanese food in the city centre near Raja Indian Cuisine is The Wrestlers. It has a price range of less than £20.
"name[The Wrestlers], eatType[pub], food[Japanese], priceRange[less than £20], area[riverside], familyFriendly[no], near[Raja Indian Cuisine]"	The Wrestlers is a pub that serves Japanese food for less than £20. It is located in the riverside area near Raja Indian Cuisine. It is not family-friendly.
"name[The Wrestlers], eatType[pub], food[Japanese], priceRange[less than £20], area[riverside], familyFriendly[yes], near[Raja Indian Cuisine]"	Near Raja Indian Cuisine in the riverside area is a pub called The Wrestlers that serves Japanese food for less than £20. It is family friendly.
"name[The Wrestlers], eatType[pub], food[Japanese], priceRange[moderate], area[city centre], familyFriendly[no], near[Raja Indian Cuisine]"	For a moderately priced Japanese pub near Raja Indian Cuisine in the city centre there is The Wrestlers. It is not kid friendly.
"name[The Wrestlers], eatType[pub], food[Japanese], priceRange[moderate], area[city centre], familyFriendly[yes], near[Raja Indian Cuisine]"	There is a moderately priced pub The Wrestlers located in the city centre near Raja Indian Cuisine. It serves Japanese food and is kid friendly.
"name[The Wrestlers], eatType[pub], food[Japanese], priceRange[moderate], area[riverside], familyFriendly[no], near[Raja Indian Cuisine]"	There is a moderately priced pub near Raja Indian Cuisine in the riverside area that serves Japanese food called The Wrestlers. It is not kid friendly.
"name[The Wrestlers], eatType[pub], food[Japanese], priceRange[moderate], area[riverside], familyFriendly[yes], near[Raja Indian Cuisine]"	The Wrestlers is a pub that serves Japanese food in the moderate price range. It is located in the riverside area near Raja Indian Cuisine. It is kid friendly.
"name[The Wrestlers], eatType[pub], food[Japanese], priceRange[moderate], customer rating[1 out of 5], area[city centre], familyFriendly[yes], near[Raja Indian Cuisine]"	In the city centre near Raja Indian Cuisine is a pub called The Wrestlers that serves Japanese food and is kid friendly. It has a moderate price range and a customer rating of 1 out of 5.
"name[The Wrestlers], eatType[pub], food[Japanese], priceRange[moderate], customer rating[1 out of 5], area[riverside], familyFriendly[no], near[Raja Indian Cuisine]"	The Wrestlers is a pub that serves Japanese food in the moderate price range. It is located in the riverside area near Raja Indian Cuisine. It is not kid friendly and has a customer rating of 1 out of 5.
"name[The Wrestlers], eatType[pub], food[Japanese], priceRange[moderate], customer rating[1 out of 5], area[riverside], familyFriendly[yes], near[Raja Indian Cuisine]"	There is a moderately priced pub called The Wrestlers that serves Japanese food and is located in the riverside area near Raja Indian Cuisine. It is kid friendly and has a customer rating of 1 out of 5.
"name[The Wrestlers], eatType[pub], food[Japanese], priceRange[more than £30], area[city centre], familyFriendly[no], near[Raja Indian Cuisine]"	If you're looking for a pub that serves Japanese food in the city centre near Raja Indian Cuisine then the Wrestlers is not child friendly. The price range is more than £30.
"name[The Wrestlers], eatType[pub], food[Japanese], priceRange[more than £30], area[city centre], familyFriendly[yes], near[Raja Indian Cuisine]"	A children friendly pub near Raja Indian Cuisine in the city centre is The Wrestlers. It serves Japanese food and has a price range of more than £30.
"name[The Wrestlers], eatType[pub], food[Japanese], priceRange[more than £30], area[riverside], familyFriendly[no], near[Raja Indian Cuisine]"	The Wrestlers is a pub that serves Japanese food in the riverside area near Raja Indian Cuisine. It is not child friendly and has a price range of more than £30.
"name[The Wrestlers], eatType[pub], food[Japanese], priceRange[more than £30], area[riverside], familyFriendly[yes], near[Raja Indian Cuisine]"	The Wrestlers is a pub that serves Japanese food in the riverside area near Raja Indian Cuisine. It is child friendly and has a price range of more than £30.
"name[The Wrestlers], eatType[pub], food[Japanese], priceRange[more than £30], customer rating[5 out of 5], area[city centre], familyFriendly[no], near[Raja Indian Cuisine]"	Near Raja Indian Cuisine in the city centre is a pub called The Wrestlers that serves Japanese food and is not child friendly. The price range is more than £30.
"name[The Wrestlers], eatType[pub], food[Japanese], priceRange[more than £30], customer rating[5 out of 5], area[city centre], familyFriendly[yes], near[Raja Indian Cuisine]"	There is a pub called The Wrestlers that serves Japanese food in the city centre near Raja Indian Cuisine. It is children friendly and has a high customer rating and a price range of more than £30.
"name[The Wrestlers], eatType[pub], food[Japanese], priceRange[more than £30], customer rating[5 out of 5], area[riverside], familyFriendly[no], near[Raja Indian Cuisine]"	There is a pub called The Wrestlers that serves Japanese food in the riverside area near Raja Indian Cuisine. It has a high customer rating and is not child friendly.
"name[The Wrestlers], eatType[pub], food[Japanese], priceRange[more than £30], customer rating[5 out of 5], area[riverside], familyFriendly[yes], near[Raja Indian Cuisine]"	"Located near Raja Indian Cuisine in the riverside area, The Wrestlers is a children friendly pub with a high customer rating and a price range of more than £30."
"name[The Wrestlers], eatType[pub], food[Japanese], priceRange[more than £30], customer rating[low], area[city centre], familyFriendly[no], near[Raja Indian Cuisine]"	"Located in the city centre near Raja Indian Cuisine, The Wrestlers is a pub that serves Japanese food with a price range of more than £30. It is not child friendly and has a low customer rating."
"name[The Wrestlers], eatType[pub], food[Japanese], priceRange[more than £30], customer rating[low], area[city centre], familyFriendly[yes], near[Raja Indian Cuisine]"	The Wrestlers is a pub that serves Japanese food in the city centre near Raja Indian Cuisine. It is children friendly and has a low customer rating.
"name[The Wrestlers], eatType[pub], food[Japanese], priceRange[more than £30], customer rating[low], area[riverside], familyFriendly[no], near[Raja Indian Cuisine]"	"Located near Raja Indian Cuisine in the riverside area, The Wrestlers is a pub that serves Japanese food with a price range of more than £30. It is not child friendly and has a low customer rating."
"name[The Wrestlers], eatType[pub], food[Japanese], priceRange[more than £30], customer rating[low], area[riverside], familyFriendly[yes], near[Raja Indian Cuisine]"	"Located near Raja Indian Cuisine in the riverside area, The Wrestlers is a pub that serves Japanese food and is children friendly and has a low customer rating."
"name[The Wrestlers], eatType[restaurant], food[Italian], priceRange[less than £20], area[riverside], familyFriendly[no], near[Raja Indian Cuisine]"	If you are looking for a family-friendly restaurant that serves Italian food in the riverside area near Raja Indian Cuisine then the Wrestlers. It is not family-friendly.
"name[The Wrestlers], eatType[restaurant], food[Italian], priceRange[less than £20], area[riverside], familyFriendly[yes], near[Raja Indian Cuisine]"	The Wrestlers is a family friendly restaurant that serves Italian food for less than £20. It is located in the riverside area near Raja Indian Cuisine.
"name[The Wrestlers], eatType[restaurant], food[Italian], priceRange[moderate], area[city centre], familyFriendly[no], near[Raja Indian Cuisine]"	Near Raja Indian Cuisine in the city centre is a Italian restaurant called The Wrestlers. It is not kid friendly and has a moderate price range.
"name[The Wrestlers], eatType[restaurant], food[Italian], priceRange[moderate], area[city centre], familyFriendly[yes], near[Raja Indian Cuisine]"	The Wrestlers is a moderately priced Italian restaurant located in the city centre near Raja Indian Cuisine. It is kid friendly.
"name[The Wrestlers], eatType[restaurant], food[Italian], priceRange[moderate], area[riverside], familyFriendly[no], near[Raja Indian Cuisine]"	Near Raja Indian Cuisine is a restaurant called The Wrestlers that serves Italian food at a moderate price range. It is not kid friendly.
"name[The Wrestlers], eatType[restaurant], food[Italian], priceRange[moderate], area[riverside], familyFriendly[yes], near[Raja Indian Cuisine]"	If you are looking for a moderately priced Italian restaurant in the riverside area then the Wrestlers is kid friendly.
"name[The Wrestlers], eatType[restaurant], food[Italian], priceRange[more than £30], area[riverside], familyFriendly[yes], near[Raja Indian Cuisine]"	The Wrestlers is a restaurant that serves Italian food in the riverside area near Raja Indian Cuisine. It is child friendly and has a price range of more than £30.
"name[The Wrestlers], eatType[restaurant], food[Japanese], priceRange[£20-25], area[riverside], familyFriendly[yes], near[Raja Indian Cuisine]"	If you are looking for a kid friendly restaurant that serves Japanese food in the riverside area near Raja Indian Cuisine is The Wrestlers.
"name[The Wrestlers], eatType[restaurant], food[Japanese], priceRange[cheap], area[riverside], familyFriendly[yes], near[Raja Indian Cuisine]"	If you are looking for a cheap family friendly restaurant in the riverside area then the Wrestlers is a fast food restaurant.
"name[The Wrestlers], eatType[restaurant], food[Japanese], priceRange[high], area[riverside], familyFriendly[yes], near[Raja Indian Cuisine]"	If you are looking for a high priced restaurant that is child friendly in the riverside area near Raja Indian Cuisine is The Wrestlers.
"name[The Wrestlers], eatType[restaurant], food[Japanese], priceRange[less than £20], area[city centre], familyFriendly[no], near[Raja Indian Cuisine]"	"Located in the city centre near Raja Indian Cuisine, The Wrestlers is a Japanese restaurant with a price range of less than £20."
"name[The Wrestlers], eatType[restaurant], food[Japanese], priceRange[less than £20], area[city centre], familyFriendly[yes], near[Raja Indian Cuisine]"	In the city centre near Raja Indian Cuisine is a family friendly restaurant called The Wrestlers. It serves Japanese food for less than £20.
"name[The Wrestlers], eatType[restaurant], food[Japanese], priceRange[less than £20], area[riverside], familyFriendly[no], near[Raja Indian Cuisine]"	There is a restaurant called The Wrestlers that serves Japanese food in the riverside area near Raja Indian Cuisine. It is not family-friendly and has a price range of less than £20.
"name[The Wrestlers], eatType[restaurant], food[Japanese], priceRange[less than £20], area[riverside], familyFriendly[yes], near[Raja Indian Cuisine]"	For a family friendly restaurant that serves Japanese food in the riverside area near Raja Indian Cuisine is The Wrestlers.
"name[The Wrestlers], eatType[restaurant], food[Japanese], priceRange[moderate], area[city centre], familyFriendly[no], near[Raja Indian Cuisine]"	Japanese restaurant The Wrestlers is located in the city centre near Raja Indian Cuisine. It is not kid friendly and has a moderate price range.
"name[The Wrestlers], eatType[restaurant], food[Japanese], priceRange[moderate], area[city centre], familyFriendly[yes], near[Raja Indian Cuisine]"	The Wrestlers is a moderately priced Japanese restaurant located in the city centre near Raja Indian Cuisine. It is kid friendly.
"name[The Wrestlers], eatType[restaurant], food[Japanese], priceRange[moderate], area[riverside], familyFriendly[no], near[Raja Indian Cuisine]"	In the riverside area near Raja Indian Cuisine is a Japanese restaurant called The Wrestlers. It is not kid friendly and has a moderate price range.
"name[The Wrestlers], eatType[restaurant], food[Japanese], priceRange[moderate], area[riverside], familyFriendly[yes], near[Raja Indian Cuisine]"	If you are looking for a moderately priced Japanese restaurant in the riverside area then the Wrestlers is kid friendly.
"name[The Wrestlers], eatType[restaurant], food[Japanese], priceRange[more than £30], area[city centre], familyFriendly[no], near[Raja Indian Cuisine]"	Japanese restaurant The Wrestlers is located in the city centre near Raja Indian Cuisine. It is not child friendly and has a price range of more than £30.
"name[The Wrestlers], eatType[restaurant], food[Japanese], priceRange[more than £30], area[city centre], familyFriendly[yes], near[Raja Indian Cuisine]"	If you are looking for a children friendly restaurant that serves Japanese food in the city centre near Raja Indian Cuisine is The Wrestlers. It has a price range of more than £30.
"name[The Wrestlers], eatType[restaurant], food[Japanese], priceRange[more than £30], area[riverside], familyFriendly[no], near[Raja Indian Cuisine]"	The Wrestlers is a restaurant that serves Japanese food in the riverside area near Raja Indian Cuisine. It is not child friendly and has a price range of more than £30.
"name[The Wrestlers], eatType[restaurant], food[Japanese], priceRange[more than £30], area[riverside], familyFriendly[yes], near[Raja Indian Cuisine]"	The Wrestlers is a restaurant that serves Japanese food in the riverside area near Raja Indian Cuisine. It is child friendly and has a price range of more than £30.
"name[Wildwood], eatType[coffee shop], area[riverside]"	In the riverside area there is a coffee shop called Wildwood. It is not family-friendly.
"name[Wildwood], eatType[pub], area[riverside]"	If you are looking for a pub called Wildwood in the riverside area.
"name[Wildwood], eatType[pub], food[French], area[riverside], familyFriendly[yes], near[Raja Indian Cuisine]"	"Located near Raja Indian Cuisine in the riverside area, Wildwood is a family friendly pub serving French food."
"name[Wildwood], eatType[pub], food[Indian], area[city centre], familyFriendly[no], near[Raja Indian Cuisine]"	If you are looking for a pub that serves Indian food in the city centre near Raja Indian Cuisine then the Wildwood is not family-friendly.
"name[Wildwood], eatType[pub], food[Indian], area[city centre], familyFriendly[yes], near[Raja Indian Cuisine]"	The Wildwood is a family-friendly pub serving Indian food near Raja Indian Cuisine in the city centre.
"name[Wildwood], eatType[pub], food[Indian], area[riverside], familyFriendly[no], near[Raja Indian Cuisine]"	In the riverside area near Raja Indian Cuisine is a pub called Wildwood that serves Indian food. It is not family-friendly.
"name[Wildwood], eatType[pub], food[Indian], area[riverside], familyFriendly[yes], near[Raja Indian Cuisine]"	If you are looking for a family friendly pub that serves Indian food in the riverside area near Raja Indian Cuisine is Wildwood.
"name[Wildwood], eatType[pub], food[Italian], area[city centre], familyFriendly[no], near[Raja Indian Cuisine]"	A pub near Raja Indian Cuisine in the city centre is Wildwood. It serves Italian food and is not family-friendly.
"name[Wildwood], eatType[pub], food[Italian], area[city centre], familyFriendly[yes], near[Raja Indian Cuisine]"	The Wildwood is a family-friendly pub serving Italian food near Raja Indian Cuisine in the city centre.
"name[Wildwood], eatType[pub], food[Italian], area[riverside], familyFriendly[no], near[Raja Indian Cuisine]"	In the riverside area near Raja Indian Cuisine is a pub called Wildwood that serves Italian food. It is not family-friendly.
"name[Wildwood], eatType[pub], food[Italian], area[riverside], familyFriendly[yes], near[Raja Indian Cuisine]"	The Wildwood is a family friendly pub serving Italian food near Raja Indian Cuisine in the riverside area.
"name[Wildwood], eatType[restaurant], food[French], area[riverside], familyFriendly[yes], near[Raja Indian Cuisine]"	Wildwood is a restaurant that serves French food and is kid friendly. It is located in the riverside area near Raja Indian Cuisine.
"name[Wildwood], eatType[restaurant], food[Indian], area[city centre], familyFriendly[no], near[Raja Indian Cuisine]"	Wildwood is a restaurant that serves Indian food. It is located in the city centre near Raja Indian Cuisine. It is not family-friendly.
"name[Wildwood], eatType[restaurant], food[Indian], area[city centre], familyFriendly[yes], near[Raja Indian Cuisine]"	If you are looking for a family-friendly restaurant that serves Indian food in the city centre near Raja Indian Cuisine is Wildwood.
"name[Wildwood], eatType[restaurant], food[Indian], area[riverside], familyFriendly[no], near[Raja Indian Cuisine]"	Wildwood is a restaurant that serves Indian food in the riverside area near Raja Indian Cuisine. It is not family-friendly.
"name[Wildwood], eatType[restaurant], food[Indian], area[riverside], familyFriendly[yes], near[Raja Indian Cuisine]"	If you are looking for a family friendly restaurant that serves Indian food in the riverside area near Raja Indian Cuisine is Wildwood.
"name[Wildwood], eatType[restaurant], food[Italian], area[city centre], familyFriendly[no], near[Raja Indian Cuisine]"	Italian restaurant Wildwood is located in the city centre near Raja Indian Cuisine. It is not family-friendly.
"name[Wildwood], eatType[restaurant], food[Italian], area[city centre], familyFriendly[yes], near[Raja Indian Cuisine]"	If you are looking for a family-friendly restaurant that serves Italian food in the city centre near Raja Indian Cuisine is Wildwood.
"name[Wildwood], eatType[restaurant], food[Italian], area[riverside], familyFriendly[no], near[Raja Indian Cuisine]"	Wildwood is a restaurant that serves Italian food in the riverside area near Raja Indian Cuisine. It is not family-friendly.
"name[Wildwood], eatType[restaurant], food[Italian], area[riverside], familyFriendly[yes], near[Raja Indian Cuisine]"	Wildwood is a restaurant that serves Italian food in the riverside area near Raja Indian Cuisine. It is family friendly.
"name[Zizzi], eatType[coffee shop], area[riverside]"	If you are looking for a coffee shop that is located in the riverside area that is child friendly is Zizzi.
"name[Zizzi], eatType[coffee shop], customer rating[average], near[Burger King]"	"Located near Burger King, Zizzi is a coffee shop with an average customer rating."
"name[Zizzi], eatType[coffee shop], customer rating[high], near[Burger King]"	If you are looking for a coffee shop near Burger King then the Zizzi is a highly rated restaurant.
"name[Zizzi], eatType[coffee shop], near[The Sorrento]"	For a cheap coffee shop near The Sorrento is Zizzi.
"name[Zizzi], eatType[pub], area[riverside]"	A pub named Zizzi is located in the riverside area.
"name[Zizzi], eatType[pub], customer rating[average], near[Burger King]"	A pub near Burger King is Zizzi. It has an average customer rating.
"name[Zizzi], eatType[pub], customer rating[high], near[Burger King]"	"With a high customer rating, Zizzi is a pub near Burger King."
"name[Zizzi], eatType[pub], near[The Sorrento]"	The Zizzi is a pub near The Sorrento.
